//MAP CONVERTED BY dmm2tgm.py THIS HEADER COMMENT PREVENTS RECONVERSION, DO NOT REMOVE
"aa" = (
/obj/machinery/porta_turret/alien/destroyed,
/turf/simulated/shuttle/floor/alienplating/vacuum,
/area/submap/outpost21/structure_generic/alienshipa)
"ab" = (
/obj/machinery/porta_turret/alien{
	check_all = 0;
	check_anomalies = 0;
	check_arrest = 0;
	check_records = 0;
	faction = "synthtide";
	use_power = 0;
	maxhealth = 500;
	health = 500
	},
/turf/simulated/shuttle/floor/alienplating/blue{
	oxygen = 0;
	phoron = 21.8366
	},
/area/submap/outpost21/structure_generic/alienshipa)
"ac" = (
/obj/machinery/door/airlock/alien/blue/public{
	name = "alien airlock"
	},
/obj/effect/mine/lube{
	camo_net = 1
	},
/turf/simulated/shuttle/floor/alien/blue{
	oxygen = 0;
	phoron = 21.8366
	},
/area/submap/outpost21/structure_generic/alienshipa)
"ad" = (
/obj/effect/mine/claymore{
	dir = 4
	},
/turf/simulated/shuttle/floor/alienplating/blue{
	oxygen = 0;
	phoron = 21.8366
	},
/area/submap/outpost21/structure_generic/alienshipa)
"ae" = (
/obj/machinery/porta_turret/alien/destroyed,
/turf/simulated/shuttle/floor/alienplating/blue{
	oxygen = 0;
	phoron = 21.8366
	},
/area/submap/outpost21/structure_generic/alienshipa)
"af" = (
/obj/effect/mine/stun{
	camo_net = 1
	},
/turf/simulated/shuttle/floor/alien/blue{
	oxygen = 0;
	phoron = 21.8366
	},
/area/submap/outpost21/structure_generic/alienshipa)
"ag" = (
/obj/effect/mine/stun{
	camo_net = 1
	},
/turf/simulated/shuttle/floor/alienplating/blue{
	oxygen = 0;
	phoron = 21.8366
	},
/area/submap/outpost21/structure_generic/alienshipa)
"ah" = (
/obj/structure/bed/alien,
/mob/living/simple_mob/mechanical/cyber_horror/vox,
/turf/simulated/shuttle/floor/alienplating/blue{
	oxygen = 0;
	phoron = 21.8366
	},
/area/submap/outpost21/structure_generic/alienshipa)
"ai" = (
/obj/item/clothing/shoes/magboots/vox,
/obj/item/clothing/under/vox/vox_casual,
/obj/item/clothing/under/vox/vox_robes,
/obj/item/tank/vox,
/obj/item/clothing/mask/breath,
/obj/structure/closet/alien,
/turf/simulated/shuttle/floor/alienplating/blue{
	oxygen = 0;
	phoron = 21.8366
	},
/area/submap/outpost21/structure_generic/alienshipa)
"aA" = (
/obj/machinery/portable_atmospherics/canister/nitrophoric_oxide,
/obj/item/tank/phoroanesthetic,
/turf/simulated/shuttle/floor/alienplating/blue{
	oxygen = 0;
	phoron = 21.8366
	},
/area/submap/outpost21/structure_generic/alienshipa)
"aM" = (
/obj/structure/meteorite,
/turf/simulated/shuttle/floor/alienplating/vacuum,
/area/submap/outpost21/structure_generic/alienshipa)
"aP" = (
/obj/machinery/chemical_dispenser/ert/specialops/abductor{
	dir = 1
	},
/turf/simulated/shuttle/floor/alienplating/blue{
	oxygen = 0;
	phoron = 21.8366
	},
/area/submap/outpost21/structure_generic/alienshipa)
"bi" = (
/obj/structure/table/alien/blue,
/obj/item/prop/alien/junk,
/obj/item/prop/alien/junk,
/obj/item/prop/alien/junk,
/obj/item/prop/alien/junk,
/obj/item/prop/alien/junk,
/obj/item/prop/alien/junk,
/turf/simulated/shuttle/floor/alienplating/blue{
	oxygen = 0;
	phoron = 21.8366
	},
/area/submap/outpost21/structure_generic/alienshipa)
"ck" = (
/obj/structure/prop/dominator/purple,
/turf/simulated/shuttle/floor/alienplating/blue{
	oxygen = 0;
	phoron = 21.8366
	},
/area/submap/outpost21/structure_generic/alienshipa)
"cr" = (
/obj/item/prop/alien/junk,
/turf/simulated/shuttle/floor/alienplating/blue{
	oxygen = 0;
	phoron = 21.8366
	},
/area/submap/outpost21/structure_generic/alienshipa)
"cN" = (
/obj/item/prop/alien/junk,
/turf/simulated/shuttle/floor/alienplating/vacuum,
/area/submap/outpost21/structure_generic/alienshipa)
"cV" = (
/obj/machinery/ion_engine{
	dir = 4
	},
/turf/simulated/shuttle/floor/alienplating/vacuum,
/area/submap/outpost21/structure_generic/alienshipa)
"dp" = (
/obj/structure/loot_pile/surface/alien,
/turf/simulated/shuttle/floor/alienplating/vacuum,
/area/submap/outpost21/structure_generic/alienshipa)
"dF" = (
/obj/structure/table/alien/blue,
/obj/item/surgical/FixOVein/alien,
/obj/item/surgical/surgicaldrill/alien{
	pixel_y = -7
	},
/turf/simulated/shuttle/floor/alienplating/blue{
	oxygen = 0;
	phoron = 21.8366
	},
/area/submap/outpost21/structure_generic/alienshipa)
"eA" = (
/obj/structure/prop/dominator/blue,
/turf/simulated/shuttle/floor/alienplating/blue{
	oxygen = 0;
	phoron = 21.8366
	},
/area/submap/outpost21/structure_generic/alienshipa)
"ft" = (
/obj/structure/lattice,
/obj/structure/meteorite,
/turf/space,
/area/submap/outpost21/structure_generic/alienshipa)
"fX" = (
/turf/simulated/shuttle/floor/alien/blue{
	oxygen = 0;
	phoron = 21.8366
	},
/area/submap/outpost21/structure_generic/alienshipa)
"kB" = (
/obj/structure/prop/machine/conduit/starts_on,
/turf/simulated/shuttle/floor/alienplating/blue{
	oxygen = 0;
	phoron = 21.8366
	},
/area/submap/outpost21/structure_generic/alienshipa)
"kG" = (
/obj/structure/bed/alien,
/turf/simulated/shuttle/floor/alienplating/blue{
	oxygen = 0;
	phoron = 21.8366
	},
/area/submap/outpost21/structure_generic/alienshipa)
"kK" = (
/turf/simulated/shuttle/wall/alien/hard_corner,
/area/submap/outpost21/structure_generic/alienshipa)
"lx" = (
/obj/structure/table/alien/blue,
/obj/item/prop/alien/junk,
/turf/simulated/shuttle/floor/alienplating/blue{
	oxygen = 0;
	phoron = 21.8366
	},
/area/submap/outpost21/structure_generic/alienshipa)
"lO" = (
/obj/item/gun/energy/medigun,
/obj/structure/table/alien/blue,
/obj/item/storage/belt/medical/alien,
/obj/item/storage/belt/medical/alien,
/turf/simulated/shuttle/floor/alien/blue{
	oxygen = 0;
	phoron = 21.8366
	},
/area/submap/outpost21/structure_generic/alienshipa)
"mv" = (
/obj/structure/prop/alien/pod,
/turf/simulated/shuttle/floor/alienplating/blue{
	oxygen = 0;
	phoron = 21.8366
	},
/area/submap/outpost21/structure_generic/alienshipa)
"ne" = (
/obj/structure/prop/dominator/orange,
/turf/simulated/shuttle/floor/alienplating/blue{
	oxygen = 0;
	phoron = 21.8366
	},
/area/submap/outpost21/structure_generic/alienshipa)
"nS" = (
/obj/structure/loot_pile/surface/alien/engineering,
/turf/simulated/shuttle/floor/alienplating/blue{
	oxygen = 0;
	phoron = 21.8366
	},
/area/submap/outpost21/structure_generic/alienshipa)
"ot" = (
/obj/structure/prop/dominator/red,
/turf/simulated/shuttle/floor/alienplating/blue{
	oxygen = 0;
	phoron = 21.8366
	},
/area/submap/outpost21/structure_generic/alienshipa)
"oD" = (
/obj/structure/closet/alien,
/turf/simulated/shuttle/floor/alienplating/blue{
	oxygen = 0;
	phoron = 21.8366
	},
/area/submap/outpost21/structure_generic/alienshipa)
"pE" = (
/obj/machinery/door/airlock/alien/blue/public{
	name = "alien airlock";
	req_one_access = list(801)
	},
/turf/simulated/shuttle/floor/alienplating/blue{
	oxygen = 0;
	phoron = 21.8366
	},
/area/submap/outpost21/structure_generic/alienshipa)
"qv" = (
/turf/simulated/shuttle/wall/alien,
/area/submap/outpost21/structure_generic/alienshipa)
"qO" = (
/obj/structure/table/alien/blue,
/obj/item/prop/alien/junk,
/obj/item/prop/alien/junk,
/obj/item/prop/alien/junk,
/obj/item/prop/alien/junk,
/obj/item/prop/alien/junk,
/obj/item/prop/alien/junk,
/obj/item/prop/alien/junk,
/obj/item/prop/alien/junk,
/obj/item/prop/alien/junk,
/obj/item/prop/alien/junk,
/turf/simulated/shuttle/floor/alienplating/blue{
	oxygen = 0;
	phoron = 21.8366
	},
/area/submap/outpost21/structure_generic/alienshipa)
"ra" = (
/obj/structure/table/alien,
/obj/machinery/turretid/lethal{
	control_area = "\improper Alien Vessel";
	req_access = list(803)
	},
/turf/simulated/shuttle/floor/alienplating/blue{
	oxygen = 0;
	phoron = 21.8366
	},
/area/submap/outpost21/structure_generic/alienshipa)
"rU" = (
/obj/structure/table/alien/blue,
/obj/item/prop/alien/junk,
/obj/item/prop/alien/junk,
/obj/item/prop/alien/junk,
/obj/item/prop/alien/junk,
/obj/item/prop/alien/junk,
/obj/item/prop/alien/junk,
/obj/item/prop/alien/junk,
/obj/item/prop/alien/junk,
/turf/simulated/shuttle/floor/alienplating/blue{
	oxygen = 0;
	phoron = 21.8366
	},
/area/submap/outpost21/structure_generic/alienshipa)
"sz" = (
/obj/structure/table/alien/blue,
/obj/item/surgical/bone_clamp/alien{
	pixel_y = -6
	},
/obj/item/surgical/circular_saw/alien{
	pixel_y = 6
	},
/turf/simulated/shuttle/floor/alien/blue{
	oxygen = 0;
	phoron = 21.8366
	},
/area/submap/outpost21/structure_generic/alienshipa)
"tg" = (
/obj/machinery/door/airlock/alien/blue/public{
	name = "alien airlock";
	req_one_access = list(803)
	},
/turf/simulated/shuttle/floor/alienplating/blue{
	oxygen = 0;
	phoron = 21.8366
	},
/area/submap/outpost21/structure_generic/alienshipa)
"ub" = (
/obj/structure/table/alien/blue,
/obj/item/roller/adv,
/turf/simulated/shuttle/floor/alienplating/blue{
	oxygen = 0;
	phoron = 21.8366
	},
/area/submap/outpost21/structure_generic/alienshipa)
"ut" = (
/obj/structure/table/alien/blue,
/obj/random/greaterportalloot,
/obj/random/greaterportalloot,
/obj/random/greaterportalloot,
/turf/simulated/shuttle/floor/alienplating/blue{
	oxygen = 0;
	phoron = 21.8366
	},
/area/submap/outpost21/structure_generic/alienshipa)
"uE" = (
/mob/living/simple_mob/mechanical/cyber_horror/vox{
	ID_provided = 1;
	myid_access = list(300)
	},
/turf/simulated/shuttle/floor/alien/blue{
	oxygen = 0;
	phoron = 21.8366
	},
/area/submap/outpost21/structure_generic/alienshipa)
"uG" = (
/obj/machinery/door/airlock/alien/blue{
	name = "bridge";
	req_one_access = list(802)
	},
/turf/simulated/shuttle/floor/alienplating/blue{
	oxygen = 0;
	phoron = 21.8366
	},
/area/submap/outpost21/structure_generic/alienshipa)
"vy" = (
/obj/machinery/power/port_gen/large_altevian,
/turf/simulated/shuttle/floor/alienplating/blue{
	oxygen = 0;
	phoron = 21.8366
	},
/area/submap/outpost21/structure_generic/alienshipa)
"vC" = (
/obj/item/vox/armalis_armour,
/obj/item/vox/armalis_amp,
/turf/simulated/shuttle/floor/alienplating/blue{
	oxygen = 0;
	phoron = 21.8366
	},
/area/submap/outpost21/structure_generic/alienshipa)
"vE" = (
/obj/structure/frame,
/turf/simulated/shuttle/floor/alienplating/blue{
	oxygen = 0;
	phoron = 21.8366
	},
/area/submap/outpost21/structure_generic/alienshipa)
"wh" = (
/obj/machinery/replicator/vore,
/turf/simulated/shuttle/floor/alienplating/blue{
	oxygen = 0;
	phoron = 21.8366
	},
/area/submap/outpost21/structure_generic/alienshipa)
"wT" = (
/obj/machinery/power/rtg/abductor/built,
/turf/simulated/shuttle/floor/alienplating/blue{
	oxygen = 0;
	phoron = 21.8366
	},
/area/submap/outpost21/structure_generic/alienshipa)
"yT" = (
/obj/structure/meteorite,
/mob/living/simple_mob/mechanical/cyber_horror/vox,
/turf/simulated/shuttle/floor/alienplating/vacuum,
/area/submap/outpost21/structure_generic/alienshipa)
"zk" = (
/turf/simulated/shuttle/floor/alienplating/blue{
	oxygen = 0;
	phoron = 21.8366
	},
/area/submap/outpost21/structure_generic/alienshipa)
"Au" = (
/obj/structure/table/alien/blue,
/obj/item/storage/firstaid/vox,
/obj/item/storage/firstaid/vox,
/obj/item/healthanalyzer/phasic{
	pixel_x = 7;
	pixel_y = 9
	},
/turf/simulated/shuttle/floor/alienplating/blue{
	oxygen = 0;
	phoron = 21.8366
	},
/area/submap/outpost21/structure_generic/alienshipa)
"BR" = (
/obj/structure/table/alien/blue,
/obj/item/card/id/keycard/blue,
/turf/simulated/shuttle/floor/alienplating/blue{
	oxygen = 0;
	phoron = 21.8366
	},
/area/submap/outpost21/structure_generic/alienshipa)
"CA" = (
/obj/machinery/door/airlock/alien/blue/public{
	name = "alien airlock"
	},
/turf/simulated/shuttle/floor/alien/blue{
	oxygen = 0;
	phoron = 21.8366
	},
/area/submap/outpost21/structure_generic/alienshipa)
"Ec" = (
/obj/structure/prop/alien/computer/camera{
	dir = 8
	},
/turf/simulated/shuttle/floor/alienplating/blue{
	oxygen = 0;
	phoron = 21.8366
	},
/area/submap/outpost21/structure_generic/alienshipa)
"Eo" = (
/obj/structure/prop/machine/alien_tank,
/turf/simulated/shuttle/floor/alienplating/blue{
	oxygen = 0;
	phoron = 21.8366
	},
/area/submap/outpost21/structure_generic/alienshipa)
"Fh" = (
/turf/simulated/shuttle/plating/airless,
/area/submap/outpost21/structure_generic/alienshipa)
"Fi" = (
/obj/structure/loot_pile/surface/alien/end,
/turf/simulated/shuttle/floor/alienplating/blue{
	oxygen = 0;
	phoron = 21.8366
	},
/area/submap/outpost21/structure_generic/alienshipa)
"FB" = (
/obj/structure/table/alien/blue,
/obj/item/surgical/cautery/alien,
/obj/item/surgical/retractor/alien{
	pixel_y = -9
	},
/obj/item/surgical/scalpel/alien{
	pixel_y = 8
	},
/turf/simulated/shuttle/floor/alienplating/blue{
	oxygen = 0;
	phoron = 21.8366
	},
/area/submap/outpost21/structure_generic/alienshipa)
"Gg" = (
/obj/structure/fans/hardlight/colorable/abductor,
/obj/machinery/door/airlock/alien/blue{
	name = "Exterior";
	req_one_access = list(801)
	},
/obj/effect/mine/dnascramble{
	camo_net = 1
	},
/turf/simulated/shuttle/floor/alienplating/blue{
	oxygen = 0;
	phoron = 21.8366
	},
/area/submap/outpost21/structure_generic/alienshipa)
"Iu" = (
/obj/structure/lattice,
/turf/space,
/area/submap/outpost21/structure_generic/alienshipa)
"Iv" = (
/turf/space,
/area/space)
"Jn" = (
/obj/structure/table/alien,
/obj/item/clothing/accessory/medal/dungeon/alien_ufo,
/turf/simulated/shuttle/floor/alienplating/blue{
	oxygen = 0;
	phoron = 21.8366
	},
/area/submap/outpost21/structure_generic/alienshipa)
"Jz" = (
/obj/machinery/door/airlock/alien/blue/public{
	name = "alien airlock";
	req_one_access = list(803)
	},
/turf/simulated/shuttle/floor/alien/blue{
	oxygen = 0;
	phoron = 21.8366
	},
/area/submap/outpost21/structure_generic/alienshipa)
"JE" = (
/obj/structure/fans/hardlight/colorable/abductor,
/obj/machinery/door/airlock/alien/blue{
	name = "Exterior";
	req_one_access = list(801)
	},
/obj/effect/mine/frag{
	camo_net = 1
	},
/turf/simulated/shuttle/floor/alienplating/blue{
	oxygen = 0;
	phoron = 21.8366
	},
/area/submap/outpost21/structure_generic/alienshipa)
"JL" = (
/obj/structure/prop/dna_vault,
/turf/simulated/shuttle/floor/alienplating/blue{
	oxygen = 0;
	phoron = 21.8366
	},
/area/submap/outpost21/structure_generic/alienshipa)
"KD" = (
/obj/structure/table/alien,
/obj/item/prop/alien/junk,
/obj/item/prop/alien/junk,
/turf/simulated/shuttle/floor/alienplating/blue{
	oxygen = 0;
	phoron = 21.8366
	},
/area/submap/outpost21/structure_generic/alienshipa)
"Le" = (
/obj/structure/prop/machine/bsb_on,
/turf/simulated/shuttle/floor/alienplating/blue{
	oxygen = 0;
	phoron = 21.8366
	},
/area/submap/outpost21/structure_generic/alienshipa)
"LP" = (
/obj/machinery/optable,
/obj/machinery/oxygen_pump/phoroanesthetic{
	pixel_x = -32
	},
/turf/simulated/shuttle/floor/alienplating/blue{
	oxygen = 0;
	phoron = 21.8366
	},
/area/submap/outpost21/structure_generic/alienshipa)
"LT" = (
/mob/living/simple_mob/mechanical/cyber_horror/vox,
/turf/simulated/shuttle/floor/alienplating/blue{
	oxygen = 0;
	phoron = 21.8366
	},
/area/submap/outpost21/structure_generic/alienshipa)
"Mc" = (
/obj/structure/loot_pile/surface/alien/security,
/turf/simulated/shuttle/floor/alienplating/blue{
	oxygen = 0;
	phoron = 21.8366
	},
/area/submap/outpost21/structure_generic/alienshipa)
"Nc" = (
/obj/structure/window/phoronreinforced{
	dir = 8
	},
/obj/structure/window/phoronreinforced{
	dir = 4
	},
/turf/simulated/shuttle/floor/alienplating/vacuum,
/area/submap/outpost21/structure_generic/alienshipa)
"NI" = (
/obj/structure/window/phoronreinforced{
	dir = 8
	},
/obj/structure/window/phoronreinforced{
	dir = 4
	},
/obj/structure/window/phoronreinforced,
/turf/simulated/shuttle/floor/alienplating/vacuum,
/area/submap/outpost21/structure_generic/alienshipa)
"Ov" = (
/obj/structure/table/alien/blue,
/obj/machinery/artifact,
/turf/simulated/shuttle/floor/alienplating/blue{
	oxygen = 0;
	phoron = 21.8366
	},
/area/submap/outpost21/structure_generic/alienshipa)
"OY" = (
/obj/effect/mine/claymore{
	dir = 8
	},
/turf/simulated/shuttle/floor/alienplating/blue{
	oxygen = 0;
	phoron = 21.8366
	},
/area/submap/outpost21/structure_generic/alienshipa)
"Pt" = (
/obj/structure/table/alien/blue,
/obj/item/storage/belt/utility/alien/full,
/obj/item/storage/belt/utility/alien/full,
/turf/simulated/shuttle/floor/alienplating/blue{
	oxygen = 0;
	phoron = 21.8366
	},
/area/submap/outpost21/structure_generic/alienshipa)
"Px" = (
/obj/machinery/sleeper/survival_pod,
/turf/simulated/shuttle/floor/alien/blue{
	oxygen = 0;
	phoron = 21.8366
	},
/area/submap/outpost21/structure_generic/alienshipa)
"PK" = (
/obj/structure/table/alien/blue,
/turf/simulated/shuttle/floor/alienplating/blue{
	oxygen = 0;
	phoron = 21.8366
	},
/area/submap/outpost21/structure_generic/alienshipa)
"Qg" = (
/turf/template_noop,
/area/template_noop)
"QE" = (
/obj/item/clothing/shoes/magboots/vox,
/obj/item/clothing/under/vox/vox_casual,
/obj/item/clothing/under/vox/vox_robes,
/obj/item/tank/vox,
/obj/item/clothing/mask/breath,
/obj/structure/closet/alien,
/obj/item/clothing/accessory/holster/leg/black,
/obj/item/clothing/gloves/vox,
/obj/item/card/id/keycard/green,
/turf/simulated/shuttle/floor/alienplating/blue{
	oxygen = 0;
	phoron = 21.8366
	},
/area/submap/outpost21/structure_generic/alienshipa)
"Rd" = (
/obj/structure/meteorite,
/turf/simulated/shuttle/plating/airless,
/area/submap/outpost21/structure_generic/alienshipa)
"RB" = (
/obj/structure/loot_pile/surface/alien/medical,
/turf/simulated/shuttle/floor/alienplating/blue{
	oxygen = 0;
	phoron = 21.8366
	},
/area/submap/outpost21/structure_generic/alienshipa)
"Sg" = (
/obj/structure/prop/alien/computer{
	dir = 8
	},
/turf/simulated/shuttle/floor/alienplating/blue{
	oxygen = 0;
	phoron = 21.8366
	},
/area/submap/outpost21/structure_generic/alienshipa)
"St" = (
/obj/machinery/door/airlock/alien/blue/public{
	name = "alien airlock"
	},
/turf/simulated/shuttle/floor/alienplating/blue{
	oxygen = 0;
	phoron = 21.8366
	},
/area/submap/outpost21/structure_generic/alienshipa)
"Td" = (
/obj/structure/prop/alien/pod/open,
/turf/simulated/shuttle/floor/alienplating/blue{
	oxygen = 0;
	phoron = 21.8366
	},
/area/submap/outpost21/structure_generic/alienshipa)
"Vb" = (
/obj/structure/prop/machine/core,
/turf/simulated/shuttle/floor/alienplating/blue{
	oxygen = 0;
	phoron = 21.8366
	},
/area/submap/outpost21/structure_generic/alienshipa)
"VL" = (
/obj/structure/prop/machine/biosyphon,
/obj/structure/table/alien/blue,
/turf/simulated/shuttle/floor/alienplating/blue{
	oxygen = 0;
	phoron = 21.8366
	},
/area/submap/outpost21/structure_generic/alienshipa)
"VX" = (
/obj/item/card/id/keycard,
/obj/item/digestion_remains/skull/vox,
/mob/living/simple_mob/mechanical/cyber_horror/vox,
/turf/simulated/shuttle/floor/alienplating/blue{
	oxygen = 0;
	phoron = 21.8366
	},
/area/submap/outpost21/structure_generic/alienshipa)
"We" = (
/obj/structure/loot_pile/surface/alien,
/turf/simulated/shuttle/floor/alienplating/blue{
	oxygen = 0;
	phoron = 21.8366
	},
/area/submap/outpost21/structure_generic/alienshipa)
"XK" = (
/obj/structure/prop/machine/alien_tank/starts_broken,
/turf/simulated/shuttle/floor/alienplating/blue{
	oxygen = 0;
	phoron = 21.8366
	},
/area/submap/outpost21/structure_generic/alienshipa)
"Yb" = (
/turf/simulated/shuttle/floor/alienplating/vacuum,
/area/submap/outpost21/structure_generic/alienshipa)
"Ym" = (
/obj/machinery/chemical_dispenser/ert/specialops/abductor,
/turf/simulated/shuttle/floor/alienplating/blue{
	oxygen = 0;
	phoron = 21.8366
	},
/area/submap/outpost21/structure_generic/alienshipa)
"Zp" = (
/obj/structure/window/phoronreinforced{
	dir = 8
	},
/obj/structure/window/phoronreinforced{
	dir = 4
	},
/obj/structure/window/phoronreinforced{
	dir = 1
	},
/turf/simulated/shuttle/floor/alienplating/vacuum,
/area/submap/outpost21/structure_generic/alienshipa)
"ZB" = (
/obj/structure/table/alien/blue,
/obj/item/surgical/bioregen,
/obj/item/surgical/bonegel,
/turf/simulated/shuttle/floor/alien/blue{
	oxygen = 0;
	phoron = 21.8366
	},
/area/submap/outpost21/structure_generic/alienshipa)
"ZI" = (
/obj/structure/table/alien,
/obj/item/toy/plushie/vox{
	name = "Iggy"
	},
/turf/simulated/shuttle/floor/alienplating/blue{
	oxygen = 0;
	phoron = 21.8366
	},
/area/submap/outpost21/structure_generic/alienshipa)

(1,1,1) = {"
Qg
Qg
Qg
Qg
Qg
Qg
Qg
Qg
Qg
Qg
Qg
Qg
Qg
Qg
Qg
Qg
Qg
Qg
Qg
Qg
Qg
Qg
Qg
Qg
Qg
Qg
Qg
Qg
Qg
Qg
Qg
Qg
Qg
Qg
Qg
Qg
Qg
Qg
Qg
Qg
Qg
Qg
Qg
Qg
Qg
Qg
Qg
Qg
Qg
Qg
"}
(2,1,1) = {"
Qg
Qg
Qg
Qg
Qg
Qg
Qg
Qg
Iv
Iv
qv
Iv
Iv
Qg
Qg
Qg
Qg
Qg
Qg
Qg
Qg
Qg
Qg
Qg
Qg
Qg
Qg
Qg
Qg
Qg
Qg
Qg
Qg
Qg
Qg
Qg
Qg
Qg
Iv
Iv
qv
Iv
Iv
Qg
Qg
Qg
Qg
Qg
Qg
Qg
"}
(3,1,1) = {"
Qg
Qg
Qg
Qg
Qg
Qg
Qg
Qg
Iv
Iv
qv
Iv
Iv
Iv
Qg
Qg
Qg
Qg
Qg
Qg
Qg
Qg
Qg
Qg
Qg
Qg
Qg
Qg
Qg
Qg
Qg
Qg
Qg
Qg
Qg
Qg
Qg
Iv
Iv
Iv
qv
Iv
Iv
Qg
Qg
Qg
Qg
Qg
Qg
Qg
"}
(4,1,1) = {"
Qg
Qg
Qg
Qg
Qg
Qg
Qg
Qg
Iv
Iv
qv
qv
Iv
Iv
Iv
Qg
Qg
Qg
Qg
Qg
Qg
Iv
Iv
Iv
Iv
Iv
Iv
Iv
Iv
Iv
Qg
Qg
Qg
Qg
Qg
Qg
Iv
Iv
Iv
qv
qv
Iv
Iv
Qg
Qg
Qg
Qg
Qg
Qg
Qg
"}
(5,1,1) = {"
Qg
Qg
Qg
Qg
Qg
Qg
Qg
Qg
Iv
Iv
qv
qv
qv
Iv
Iv
Iv
Qg
Qg
Qg
Qg
Iv
Iv
Iv
Iv
Iv
Iv
Iv
Iv
Iv
Iv
Iv
Qg
Qg
Qg
Qg
Iv
Iv
Iv
qv
qv
qv
Iv
Iv
Qg
Qg
Qg
Qg
Qg
Qg
Qg
"}
(6,1,1) = {"
Qg
Qg
Qg
Qg
Qg
Qg
Qg
Qg
Iv
Iv
qv
QE
qv
qv
Iv
Iv
Iv
Iv
Qg
Qg
Iv
Iv
Iv
qv
cV
cV
cV
qv
Iv
Iv
Iv
Qg
Qg
Iv
Iv
Iv
Iv
qv
qv
aA
qv
Iv
Iv
Qg
Qg
Qg
Qg
Qg
Qg
Qg
"}
(7,1,1) = {"
Qg
Qg
Qg
Qg
Qg
Qg
Qg
Qg
Iv
Iv
qv
ah
zk
qv
qv
Iv
Iv
Iv
Iv
Iv
Iv
Iv
qv
qv
Zp
Nc
NI
qv
qv
Iv
Iv
Iv
Iv
Iv
Iv
Iv
qv
qv
bi
zk
qv
Iv
Iv
Qg
Qg
Qg
Qg
Qg
Qg
Qg
"}
(8,1,1) = {"
Qg
Qg
Qg
Qg
Qg
Qg
Qg
Qg
Iv
Iv
qv
zk
zk
qv
qv
qv
Iv
Iv
Iv
Iv
Iv
Iv
qv
zk
vy
ae
zk
vy
qv
Iv
Iv
Iv
Iv
Iv
Iv
qv
qv
LP
zk
zk
qv
Iv
Iv
Qg
Qg
Qg
Qg
Qg
Qg
Qg
"}
(9,1,1) = {"
Qg
Qg
Qg
Qg
Qg
Qg
Qg
Qg
Iv
Iv
qv
kK
pE
kK
ab
qv
qv
qv
qv
qv
qv
Iv
qv
zk
zk
zk
zk
zk
qv
Iv
qv
qv
qv
qv
qv
qv
Au
zk
zk
dF
qv
Iv
Iv
Qg
Qg
Qg
Qg
Qg
Qg
Qg
"}
(10,1,1) = {"
Qg
Qg
Qg
Qg
Qg
Qg
Qg
Qg
Iv
Iv
qv
ab
zk
zk
zk
zk
qv
kK
ab
zk
kK
JE
qv
kB
zk
zk
zk
Vb
qv
Gg
kK
zk
ab
kK
qv
Px
zk
zk
zk
FB
qv
Iv
Iv
Qg
Qg
Qg
Qg
Qg
Qg
Qg
"}
(11,1,1) = {"
Qg
Qg
Qg
Qg
Qg
Qg
Qg
Qg
Iv
Iv
qv
qv
qv
kK
zk
zk
qv
zk
zk
zk
zk
zk
qv
nS
zk
LT
zk
nS
qv
zk
zk
zk
zk
zk
qv
zk
zk
RB
zk
sz
qv
Iv
Iv
Qg
Qg
Qg
Qg
Qg
Qg
Qg
"}
(12,1,1) = {"
Qg
Qg
Qg
Qg
Qg
Qg
Qg
Qg
Iv
Iv
qv
oD
kG
St
zk
zk
qv
zk
zk
zk
zk
zk
qv
wT
zk
Le
zk
wT
qv
zk
zk
zk
zk
zk
qv
zk
zk
RB
zk
ub
qv
Iv
Iv
Qg
Qg
Qg
Qg
Qg
Qg
Qg
"}
(13,1,1) = {"
Qg
Qg
Qg
Qg
Qg
Qg
Qg
Qg
Iv
Iv
qv
qv
qv
kK
zk
fX
kK
fX
zk
kK
ag
zk
qv
wT
fX
fX
fX
wT
qv
zk
zk
kK
zk
fX
kK
fX
LT
zk
zk
zk
qv
Iv
Iv
Qg
Qg
Qg
Qg
Qg
Qg
Qg
"}
(14,1,1) = {"
Qg
Qg
Qg
Qg
Qg
Qg
Qg
Qg
Iv
Iv
qv
ai
ah
St
zk
fX
CA
fX
fX
qv
zk
zk
qv
qv
kK
pE
kK
qv
qv
zk
zk
qv
fX
fX
tg
fX
zk
zk
lO
ZB
qv
Iv
Iv
Qg
Qg
Qg
Qg
Qg
Qg
Qg
"}
(15,1,1) = {"
Qg
Qg
Qg
Qg
Qg
Qg
Qg
Qg
Iv
Iv
qv
qv
qv
qv
qv
qv
kK
CA
CA
qv
zk
zk
zk
zk
fX
fX
fX
zk
zk
zk
zk
qv
CA
CA
kK
qv
qv
qv
qv
qv
qv
Iv
Iv
Qg
Qg
Qg
Qg
Qg
Qg
Qg
"}
(16,1,1) = {"
Qg
Qg
Qg
Qg
Qg
Qg
Qg
Qg
Iv
Iv
Iv
qv
qv
zk
zk
JL
ck
fX
fX
qv
fX
fX
zk
zk
zk
LT
zk
zk
zk
fX
fX
qv
cN
Yb
Yb
cN
Yb
Yb
dp
qv
Iv
Iv
Iv
Qg
Qg
Qg
Qg
Qg
Qg
Qg
"}
(17,1,1) = {"
Qg
Qg
Qg
Qg
Qg
Qg
Qg
Qg
Iv
Iv
Iv
qv
qv
zk
uE
fX
zk
zk
zk
qv
CA
ac
qv
qv
qv
qv
qv
qv
qv
CA
ac
qv
Yb
yT
Yb
Rd
Yb
Fh
aa
qv
Iv
Iv
Iv
Qg
Qg
Qg
Qg
Qg
Qg
Qg
"}
(18,1,1) = {"
Qg
Qg
Qg
Qg
Qg
Qg
Qg
Qg
Iv
Iv
Iv
qv
qv
zk
zk
zk
zk
zk
zk
qv
fX
fX
qv
Eo
zk
ab
zk
Eo
qv
fX
fX
qv
Fh
cN
Fh
Yb
Yb
Yb
qv
qv
Iv
Iv
Iv
Qg
Qg
Qg
Qg
Qg
Qg
Qg
"}
(19,1,1) = {"
Qg
Qg
Qg
Qg
Qg
Qg
Qg
Qg
Qg
Iv
Iv
Iv
qv
qv
qv
kK
Ym
zk
zk
qv
zk
zk
qv
Eo
zk
zk
zk
XK
qv
zk
zk
qv
aM
Yb
ft
Yb
Rd
Iu
qv
Iv
Iv
Iv
Qg
Qg
Qg
Qg
Qg
Qg
Qg
Qg
"}
(20,1,1) = {"
Qg
Qg
Qg
Qg
Qg
Qg
Qg
Qg
Qg
Iv
Iv
Iv
Iv
qv
qv
qv
aP
zk
zk
qv
zk
zk
qv
XK
zk
zk
zk
Eo
qv
zk
zk
qv
Yb
Yb
Yb
Yb
Iu
Iv
Iv
Iv
Iv
Iv
Qg
Qg
Qg
Qg
Qg
Qg
Qg
Qg
"}
(21,1,1) = {"
Qg
Qg
Qg
Qg
Qg
Qg
Qg
Qg
Qg
Qg
Iv
Iv
Iv
Iv
qv
qv
We
zk
zk
qv
zk
zk
qv
VL
zk
LT
zk
eA
qv
zk
zk
qv
Yb
Yb
Fh
Iu
Iv
Iv
Iv
Iv
Iv
Qg
Qg
Qg
Qg
Qg
Qg
Qg
Qg
Qg
"}
(22,1,1) = {"
Qg
Qg
Qg
Qg
Qg
Qg
Qg
Qg
Qg
Qg
Iv
Iv
Iv
Iv
Iv
qv
qv
zk
zk
qv
zk
zk
qv
vE
zk
zk
zk
eA
qv
zk
zk
qv
Fh
Yb
Fh
Iv
Iv
Iv
Iv
Iv
Iv
Qg
Qg
Qg
Qg
Qg
Qg
Qg
Qg
Qg
"}
(23,1,1) = {"
Qg
Qg
Qg
Qg
Qg
Qg
Qg
Qg
Qg
Qg
Qg
Iv
Iv
Iv
Iv
Iv
qv
qv
ab
qv
zk
zk
qv
Ov
zk
zk
zk
Ov
qv
zk
zk
qv
aa
qv
Iu
Iv
Iv
Iv
Iv
Iv
Qg
Qg
Qg
Qg
Qg
Qg
Qg
Qg
Qg
Qg
"}
(24,1,1) = {"
Qg
Qg
Qg
Qg
Qg
Qg
Qg
Qg
Qg
Qg
Qg
Qg
Iv
Iv
Iv
Iv
Iv
qv
qv
qv
zk
zk
qv
qv
fX
fX
fX
qv
qv
zk
zk
qv
qv
qv
Iv
Iv
Iv
Iv
Iv
Qg
Qg
Qg
Qg
Qg
Qg
Qg
Qg
Qg
Qg
Qg
"}
(25,1,1) = {"
Qg
Qg
Qg
Qg
Qg
Qg
Qg
Qg
Qg
Qg
Qg
Qg
Qg
Iv
Iv
Iv
Iv
Iv
qv
qv
OY
zk
ab
qv
kK
Jz
kK
qv
ab
zk
OY
qv
qv
Iv
Iv
Iv
Iv
Iv
Qg
Qg
Qg
Qg
Qg
Qg
Qg
Qg
Qg
Qg
Qg
Qg
"}
(26,1,1) = {"
Qg
Qg
Qg
Qg
Qg
Qg
Qg
Qg
Qg
Qg
Qg
Qg
Qg
Qg
Iv
Iv
Iv
Iv
Iv
qv
qv
zk
zk
zk
fX
fX
fX
zk
zk
zk
qv
qv
Iv
Iv
Iv
Iv
Iv
Qg
Qg
Qg
Qg
Qg
Qg
Qg
Qg
Qg
Qg
Qg
Qg
Qg
"}
(27,1,1) = {"
Qg
Qg
Qg
Qg
Qg
Qg
Qg
Qg
Qg
Qg
Qg
Qg
Qg
Qg
Qg
Iv
Iv
Iv
Iv
qv
qv
zk
zk
zk
fX
fX
fX
zk
zk
zk
qv
qv
Iv
Iv
Iv
Iv
Qg
Qg
Qg
Qg
Qg
Qg
Qg
Qg
Qg
Qg
Qg
Qg
Qg
Qg
"}
(28,1,1) = {"
Qg
Qg
Qg
Qg
Qg
Qg
Qg
Qg
Qg
Qg
Qg
Qg
Qg
Qg
Qg
Qg
Iv
Iv
Iv
qv
ad
zk
ab
qv
kK
Jz
kK
qv
ab
zk
ad
qv
Iv
Iv
Iv
Qg
Qg
Qg
Qg
Qg
Qg
Qg
Qg
Qg
Qg
Qg
Qg
Qg
Qg
Qg
"}
(29,1,1) = {"
Qg
Qg
Qg
Qg
Qg
Qg
Qg
Qg
Qg
Qg
Qg
Qg
Qg
Qg
Qg
Qg
Qg
Iv
Iv
qv
zk
zk
qv
qv
fX
fX
fX
qv
qv
zk
zk
qv
Iv
Iv
Qg
Qg
Qg
Qg
Qg
Qg
Qg
Qg
Qg
Qg
Qg
Qg
Qg
Qg
Qg
Qg
"}
(30,1,1) = {"
Qg
Qg
Qg
Qg
Qg
Qg
Qg
Qg
Qg
Qg
Qg
Qg
Qg
Qg
Qg
Qg
Qg
Iv
Iv
qv
zk
zk
qv
ne
zk
rU
LT
ot
qv
zk
zk
qv
Iv
Iv
Qg
Qg
Qg
Qg
Qg
Qg
Qg
Qg
Qg
Qg
Qg
Qg
Qg
Qg
Qg
Qg
"}
(31,1,1) = {"
Qg
Qg
Qg
Qg
Qg
Qg
Qg
Qg
Qg
Qg
Qg
Qg
Qg
Qg
Qg
Qg
Qg
Iv
Iv
qv
zk
zk
qv
mv
zk
rU
zk
Td
qv
zk
zk
qv
Iv
Iv
Qg
Qg
Qg
Qg
Qg
Qg
Qg
Qg
Qg
Qg
Qg
Qg
Qg
Qg
Qg
Qg
"}
(32,1,1) = {"
Qg
Qg
Qg
Qg
Qg
Qg
Qg
Qg
Qg
Qg
Qg
Qg
Qg
Qg
Qg
Qg
Qg
Iv
Iv
qv
zk
zk
qv
mv
LT
lx
LT
wh
qv
zk
zk
qv
Iv
Iv
Qg
Qg
Qg
Qg
Qg
Qg
Qg
Qg
Qg
Qg
Qg
Qg
Qg
Qg
Qg
Qg
"}
(33,1,1) = {"
Qg
Qg
Qg
Qg
Qg
Qg
Qg
Qg
Qg
Qg
Qg
Qg
Qg
Qg
Qg
Qg
Qg
Iv
Iv
qv
zk
zk
qv
Mc
zk
PK
zk
Mc
qv
zk
zk
qv
Iv
Iv
Qg
Qg
Qg
Qg
Qg
Qg
Qg
Qg
Qg
Qg
Qg
Qg
Qg
Qg
Qg
Qg
"}
(34,1,1) = {"
Qg
Qg
Qg
Qg
Qg
Qg
Qg
Qg
Qg
Qg
Qg
Qg
Qg
Qg
Qg
Qg
Qg
Iv
Iv
qv
zk
zk
qv
Mc
zk
PK
zk
Mc
qv
zk
zk
qv
Iv
Iv
Qg
Qg
Qg
Qg
Qg
Qg
Qg
Qg
Qg
Qg
Qg
Qg
Qg
Qg
Qg
Qg
"}
(35,1,1) = {"
Qg
Qg
Qg
Qg
Qg
Qg
Qg
Qg
Qg
Qg
Qg
Qg
Qg
Qg
Qg
Qg
Qg
Iv
Iv
qv
zk
zk
qv
qO
zk
PK
zk
ut
qv
zk
zk
qv
Iv
Iv
Qg
Qg
Qg
Qg
Qg
Qg
Qg
Qg
Qg
Qg
Qg
Qg
Qg
Qg
Qg
Qg
"}
(36,1,1) = {"
Qg
Qg
Qg
Qg
Qg
Qg
Qg
Qg
Qg
Qg
Qg
Qg
Qg
Qg
Qg
Qg
Qg
Iv
Iv
qv
zk
zk
qv
qO
zk
PK
zk
ut
qv
zk
zk
qv
Iv
Iv
Qg
Qg
Qg
Qg
Qg
Qg
Qg
Qg
Qg
Qg
Qg
Qg
Qg
Qg
Qg
Qg
"}
(37,1,1) = {"
Qg
Qg
Qg
Qg
Qg
Qg
Qg
Qg
Qg
Qg
Qg
Qg
Qg
Qg
Qg
Qg
Qg
Iv
Iv
qv
zk
zk
qv
qO
zk
zk
zk
Pt
qv
zk
zk
qv
Iv
Iv
Qg
Qg
Qg
Qg
Qg
Qg
Qg
Qg
Qg
Qg
Qg
Qg
Qg
Qg
Qg
Qg
"}
(38,1,1) = {"
Qg
Qg
Qg
Qg
Qg
Qg
Qg
Qg
Qg
Qg
Qg
Qg
Qg
Qg
Qg
Qg
Qg
Iv
Iv
qv
zk
zk
qv
qv
zk
BR
zk
qv
qv
zk
zk
qv
Iv
Iv
Qg
Qg
Qg
Qg
Qg
Qg
Qg
Qg
Qg
Qg
Qg
Qg
Qg
Qg
Qg
Qg
"}
(39,1,1) = {"
Qg
Qg
Qg
Qg
Qg
Qg
Qg
Qg
Qg
Qg
Qg
Qg
Qg
Qg
Qg
Qg
Qg
Iv
Iv
qv
OY
zk
zk
qv
qv
qv
qv
qv
zk
zk
OY
qv
Iv
Iv
Qg
Qg
Qg
Qg
Qg
Qg
Qg
Qg
Qg
Qg
Qg
Qg
Qg
Qg
Qg
Qg
"}
(40,1,1) = {"
Qg
Qg
Qg
Qg
Qg
Qg
Qg
Qg
Qg
Qg
Qg
Qg
Qg
Qg
Qg
Qg
Qg
Iv
Iv
qv
qv
zk
zk
zk
zk
VX
zk
zk
zk
zk
qv
qv
Iv
Iv
Qg
Qg
Qg
Qg
Qg
Qg
Qg
Qg
Qg
Qg
Qg
Qg
Qg
Qg
Qg
Qg
"}
(41,1,1) = {"
Qg
Qg
Qg
Qg
Qg
Qg
Qg
Qg
Qg
Qg
Qg
Qg
Qg
Qg
Qg
Qg
Qg
Iv
Iv
Iv
qv
ab
zk
zk
fX
fX
fX
zk
zk
ab
qv
Iv
Iv
Iv
Qg
Qg
Qg
Qg
Qg
Qg
Qg
Qg
Qg
Qg
Qg
Qg
Qg
Qg
Qg
Qg
"}
(42,1,1) = {"
Qg
Qg
Qg
Qg
Qg
Qg
Qg
Qg
Qg
Qg
Qg
Qg
Qg
Qg
Qg
Qg
Qg
Iv
Iv
Iv
qv
qv
qv
qv
kK
uG
kK
qv
qv
qv
qv
Iv
Iv
Iv
Qg
Qg
Qg
Qg
Qg
Qg
Qg
Qg
Qg
Qg
Qg
Qg
Qg
Qg
Qg
Qg
"}
(43,1,1) = {"
Qg
Qg
Qg
Qg
Qg
Qg
Qg
Qg
Qg
Qg
Qg
Qg
Qg
Qg
Qg
Qg
Qg
Qg
Iv
Iv
qv
ab
cr
zk
fX
af
fX
zk
zk
ab
qv
Iv
Iv
Qg
Qg
Qg
Qg
Qg
Qg
Qg
Qg
Qg
Qg
Qg
Qg
Qg
Qg
Qg
Qg
Qg
"}
(44,1,1) = {"
Qg
Qg
Qg
Qg
Qg
Qg
Qg
Qg
Qg
Qg
Qg
Qg
Qg
Qg
Qg
Qg
Qg
Qg
Iv
Iv
qv
qv
Fi
zk
zk
zk
zk
zk
Fi
qv
qv
Iv
Iv
Qg
Qg
Qg
Qg
Qg
Qg
Qg
Qg
Qg
Qg
Qg
Qg
Qg
Qg
Qg
Qg
Qg
"}
(45,1,1) = {"
Qg
Qg
Qg
Qg
Qg
Qg
Qg
Qg
Qg
Qg
Qg
Qg
Qg
Qg
Qg
Qg
Qg
Qg
Iv
Iv
Iv
qv
KD
zk
zk
zk
zk
zk
ra
qv
Iv
Iv
Iv
Qg
Qg
Qg
Qg
Qg
Qg
Qg
Qg
Qg
Qg
Qg
Qg
Qg
Qg
Qg
Qg
Qg
"}
(46,1,1) = {"
Qg
Qg
Qg
Qg
Qg
Qg
Qg
Qg
Qg
Qg
Qg
Qg
Qg
Qg
Qg
Qg
Qg
Qg
Iv
Iv
Iv
qv
ZI
zk
zk
vC
zk
zk
Jn
qv
Iv
Iv
Iv
Qg
Qg
Qg
Qg
Qg
Qg
Qg
Qg
Qg
Qg
Qg
Qg
Qg
Qg
Qg
Qg
Qg
"}
(47,1,1) = {"
Qg
Qg
Qg
Qg
Qg
Qg
Qg
Qg
Qg
Qg
Qg
Qg
Qg
Qg
Qg
Qg
Qg
Qg
Qg
Iv
Iv
qv
qv
qv
Ec
Sg
Sg
qv
qv
qv
Iv
Iv
Qg
Qg
Qg
Qg
Qg
Qg
Qg
Qg
Qg
Qg
Qg
Qg
Qg
Qg
Qg
Qg
Qg
Qg
"}
(48,1,1) = {"
Qg
Qg
Qg
Qg
Qg
Qg
Qg
Qg
Qg
Qg
Qg
Qg
Qg
Qg
Qg
Qg
Qg
Qg
Qg
Iv
Iv
Iv
Iv
qv
qv
qv
qv
qv
Iv
Iv
Iv
Iv
Qg
Qg
Qg
Qg
Qg
Qg
Qg
Qg
Qg
Qg
Qg
Qg
Qg
Qg
Qg
Qg
Qg
Qg
"}
(49,1,1) = {"
Qg
Qg
Qg
Qg
Qg
Qg
Qg
Qg
Qg
Qg
Qg
Qg
Qg
Qg
Qg
Qg
Qg
Qg
Qg
Qg
Iv
Iv
Iv
Iv
Iv
Iv
Iv
Iv
Iv
Iv
Iv
Qg
Qg
Qg
Qg
Qg
Qg
Qg
Qg
Qg
Qg
Qg
Qg
Qg
Qg
Qg
Qg
Qg
Qg
Qg
"}
(50,1,1) = {"
Qg
Qg
Qg
Qg
Qg
Qg
Qg
Qg
Qg
Qg
Qg
Qg
Qg
Qg
Qg
Qg
Qg
Qg
Qg
Qg
Qg
Qg
Qg
Qg
Qg
Qg
Qg
Qg
Qg
Qg
Qg
Qg
Qg
Qg
Qg
Qg
Qg
Qg
Qg
Qg
Qg
Qg
Qg
Qg
Qg
Qg
Qg
Qg
Qg
Qg
"}
