//MAP CONVERTED BY dmm2tgm.py THIS HEADER COMMENT PREVENTS RECONVERSION, DO NOT REMOVE
"a" = (
/turf/space,
/area/template_noop)
"b" = (
/obj/structure/closet/crate,
/obj/random/handgun/sec,
/obj/random/handgun/sec,
/turf/simulated/mineral/floor/vacuum,
/area/submap/outpost21/asteroid_generic)
"c" = (
/obj/effect/mine/lube,
/turf/simulated/mineral/floor/vacuum,
/area/submap/outpost21/asteroid_generic)
"d" = (
/obj/random/maintenance/medical,
/turf/simulated/mineral/floor/vacuum,
/area/submap/outpost21/asteroid_generic)
"f" = (
/obj/effect/mine/confetti,
/turf/simulated/mineral/floor/vacuum,
/area/submap/outpost21/asteroid_generic)
"i" = (
/turf/simulated/mineral/floor/vacuum,
/area/submap/outpost21/asteroid_generic)
"k" = (
/obj/random/contraband/nofail,
/obj/structure/closet/crate,
/obj/random/maintenance/medical,
/turf/simulated/mineral/floor/vacuum,
/area/submap/outpost21/asteroid_generic)
"l" = (
/obj/random/contraband/nofail,
/obj/structure/closet/crate,
/turf/simulated/mineral/floor/vacuum,
/area/submap/outpost21/asteroid_generic)
"m" = (
/obj/random/cutout,
/turf/simulated/mineral/floor/vacuum,
/area/submap/outpost21/asteroid_generic)
"n" = (
/turf/simulated/mineral/vacuum,
/area/submap/outpost21/asteroid_generic)
"p" = (
/obj/structure/lattice,
/obj/machinery/trailblazer/yellow,
/turf/space,
/area/template_noop)
"r" = (
/obj/effect/mine/lasertag/omni,
/turf/simulated/mineral/floor/vacuum,
/area/submap/outpost21/asteroid_generic)
"v" = (
/obj/effect/mine/claymore/donksoft{
	dir = 4
	},
/turf/simulated/mineral/floor/vacuum,
/area/submap/outpost21/asteroid_generic)
"x" = (
/obj/effect/step_trigger/dephase_shadekin,
/turf/unsimulated/mineral/muriki/basalt,
/area/submap/outpost21/asteroid_generic)
"B" = (
/obj/effect/mine/claymore{
	dir = 8
	},
/turf/simulated/mineral/floor/vacuum,
/area/submap/outpost21/asteroid_generic)
"C" = (
/turf/template_noop,
/area/template_noop)
"D" = (
/turf/unsimulated/mineral/muriki/basalt,
/area/submap/outpost21/asteroid_generic)
"E" = (
/obj/effect/mine/emp/camo,
/turf/simulated/mineral/floor/vacuum,
/area/submap/outpost21/asteroid_generic)
"G" = (
/obj/effect/mine/frag,
/turf/simulated/mineral/floor/vacuum,
/area/submap/outpost21/asteroid_generic)
"H" = (
/obj/structure/closet/crate,
/obj/random/energy/highend,
/obj/random/energy/highend,
/turf/simulated/mineral/floor/vacuum,
/area/submap/outpost21/asteroid_generic)
"I" = (
/obj/effect/mine/stun,
/turf/simulated/mineral/floor/vacuum,
/area/submap/outpost21/asteroid_generic)
"J" = (
/obj/effect/step_trigger/claymore_laser{
	dir = 4
	},
/turf/simulated/mineral/floor/vacuum,
/area/submap/outpost21/asteroid_generic)
"M" = (
/obj/structure/closet/crate,
/obj/random/maintenance/research,
/turf/simulated/mineral/floor/vacuum,
/area/submap/outpost21/asteroid_generic)
"N" = (
/obj/effect/landmark{
	name = "carpspawn"
	},
/turf/space,
/area/template_noop)
"P" = (
/obj/structure/lattice,
/turf/space,
/area/template_noop)
"Q" = (
/obj/random,
/turf/simulated/mineral/floor/vacuum,
/area/submap/outpost21/asteroid_generic)
"R" = (
/obj/effect/step_trigger/dephase_shadekin,
/obj/effect/step_trigger/dephase_shadekin,
/turf/unsimulated/mineral/muriki/basalt,
/area/submap/outpost21/asteroid_generic)
"S" = (
/obj/structure/closet/crate,
/obj/random/material/precious,
/obj/random/material/precious,
/turf/simulated/mineral/floor/vacuum,
/area/submap/outpost21/asteroid_generic)
"W" = (
/obj/random/flashlight,
/turf/simulated/mineral/floor/vacuum,
/area/submap/outpost21/asteroid_generic)
"Z" = (
/obj/random/cutout,
/obj/effect/mine/stun,
/turf/simulated/mineral/floor/vacuum,
/area/submap/outpost21/asteroid_generic)

(1,1,1) = {"
C
C
C
C
C
C
C
C
C
C
C
C
C
C
C
C
C
C
C
C
C
C
C
C
C
C
C
C
C
C
C
C
C
C
C
C
C
C
C
C
C
C
C
C
C
C
C
C
C
C
C
C
C
C
C
C
C
C
"}
(2,1,1) = {"
C
C
C
C
C
C
C
C
C
C
C
C
C
C
C
C
C
C
C
C
C
C
C
C
C
C
C
C
C
C
C
C
C
C
C
C
C
C
C
C
C
C
C
C
C
C
C
C
C
C
C
C
C
C
C
C
C
C
"}
(3,1,1) = {"
C
C
C
C
C
C
C
C
a
a
a
C
C
C
a
a
a
a
a
a
a
C
C
C
C
C
C
C
C
C
C
C
C
C
C
a
a
a
a
a
a
a
C
C
C
C
C
C
C
C
C
C
C
C
C
C
C
C
"}
(4,1,1) = {"
C
C
C
C
C
C
C
a
a
a
a
a
C
a
a
a
a
a
a
a
a
a
a
a
a
a
a
C
C
C
C
C
C
C
a
a
a
a
a
a
a
a
a
C
C
C
C
C
C
C
C
C
C
C
C
C
C
C
"}
(5,1,1) = {"
C
C
C
C
C
a
a
a
n
n
n
a
a
a
a
a
a
n
n
n
a
a
a
a
a
a
a
a
a
a
a
a
a
a
a
a
n
n
a
a
n
n
a
a
C
C
C
C
C
C
C
C
C
C
C
C
C
C
"}
(6,1,1) = {"
C
C
C
C
a
a
a
n
n
n
n
a
a
a
n
n
n
n
n
n
n
a
a
a
a
p
a
a
a
p
a
a
a
a
a
a
n
n
n
a
n
n
n
a
a
C
C
C
C
C
C
C
C
C
C
C
C
C
"}
(7,1,1) = {"
C
C
C
C
a
a
n
n
n
n
n
n
n
n
n
n
n
n
n
n
n
a
a
a
a
P
a
a
a
n
n
n
a
a
N
a
n
n
n
n
n
n
n
a
a
a
C
C
C
C
C
C
C
C
C
C
C
C
"}
(8,1,1) = {"
C
C
C
C
a
a
n
n
n
n
n
n
n
n
n
n
n
n
n
n
n
n
a
N
a
P
a
a
a
n
n
n
n
a
a
n
n
n
n
n
n
n
n
n
a
a
a
C
C
C
C
C
C
C
C
C
C
C
"}
(9,1,1) = {"
C
C
C
C
a
a
n
n
n
n
n
n
n
n
n
n
n
n
D
D
n
n
n
a
a
P
a
a
n
n
n
n
n
n
n
n
n
n
n
D
D
D
n
n
a
a
a
a
C
C
C
C
C
C
C
C
C
C
"}
(10,1,1) = {"
C
C
C
C
a
a
n
n
n
n
n
n
n
n
n
D
D
D
D
D
D
D
n
n
n
n
a
a
n
n
D
D
D
D
n
D
D
n
D
D
D
D
n
n
n
n
a
a
a
a
a
C
C
C
C
C
C
C
"}
(11,1,1) = {"
C
C
C
C
a
a
a
n
n
n
n
n
n
n
D
D
D
D
D
D
D
D
D
D
D
D
n
a
n
D
D
D
D
D
D
D
D
D
D
D
D
D
D
n
n
n
n
a
a
a
a
a
a
C
C
C
C
C
"}
(12,1,1) = {"
C
C
C
C
a
a
a
a
a
n
n
n
n
D
D
D
D
x
x
x
x
x
x
x
x
x
x
i
x
x
x
x
x
x
x
x
x
x
x
x
D
D
D
n
n
n
n
n
n
n
a
a
a
C
C
C
C
C
"}
(13,1,1) = {"
C
C
C
C
a
a
a
a
a
n
n
n
n
D
D
D
D
x
E
i
i
D
Z
i
d
D
D
i
D
D
D
i
i
i
D
D
D
k
i
x
D
D
D
D
D
n
n
n
n
n
n
a
a
C
C
C
C
C
"}
(14,1,1) = {"
C
C
C
C
a
a
a
a
n
n
n
n
n
n
n
D
D
x
i
D
i
D
i
D
i
D
D
i
i
i
D
D
D
i
m
i
D
D
i
x
D
D
D
D
D
n
n
n
n
n
n
a
a
C
C
C
C
C
"}
(15,1,1) = {"
C
C
C
C
a
a
a
n
n
n
n
n
n
n
n
D
D
x
i
D
i
D
i
D
i
D
i
i
D
W
i
i
D
r
D
i
D
m
i
x
D
D
D
D
D
n
n
n
n
n
n
a
a
C
C
C
C
C
"}
(16,1,1) = {"
C
C
C
C
a
a
n
n
n
n
n
n
n
n
D
D
D
x
i
D
i
D
i
D
i
D
i
D
D
D
D
i
D
i
D
i
D
i
D
x
D
D
D
D
n
n
n
n
n
n
n
a
a
C
C
C
C
C
"}
(17,1,1) = {"
C
C
C
C
a
a
n
n
n
n
n
n
n
n
D
D
D
x
i
D
i
D
i
D
i
D
i
D
D
D
i
i
D
i
D
i
D
E
i
x
D
D
D
D
n
n
n
n
n
n
n
a
a
C
C
C
C
C
"}
(18,1,1) = {"
C
C
C
C
a
a
n
n
n
n
n
n
n
D
D
D
D
x
i
D
i
D
i
D
i
D
i
W
D
D
i
D
D
i
D
i
D
D
i
x
D
D
D
n
n
n
n
n
n
n
n
a
a
C
C
C
C
C
"}
(19,1,1) = {"
C
C
C
C
a
a
a
a
a
n
n
n
n
D
D
D
D
x
i
D
c
D
i
D
i
D
D
i
i
i
i
D
i
i
D
i
D
i
i
x
D
D
D
D
D
D
n
n
n
n
n
a
a
C
C
C
C
C
"}
(20,1,1) = {"
C
C
C
C
a
a
a
a
a
a
a
a
n
n
D
D
D
x
i
D
i
D
i
D
i
v
D
D
i
D
D
D
v
D
D
i
D
i
D
x
D
D
D
D
D
D
n
n
n
n
n
a
a
C
C
C
C
C
"}
(21,1,1) = {"
C
C
C
C
a
a
a
a
a
a
a
n
n
n
D
D
D
x
i
D
i
D
i
D
D
J
i
i
i
i
i
i
J
D
i
i
D
i
i
x
D
D
D
D
D
D
n
n
n
n
n
a
a
C
C
C
C
C
"}
(22,1,1) = {"
C
C
C
C
a
N
a
a
a
a
a
n
n
n
D
D
D
x
i
D
i
D
i
r
D
D
D
D
D
D
D
D
D
D
i
D
D
D
i
x
D
D
D
D
D
n
n
n
n
n
a
a
a
C
C
C
C
C
"}
(23,1,1) = {"
C
C
C
C
a
a
a
a
a
a
n
n
n
n
n
D
D
x
i
D
i
D
D
i
i
D
i
i
i
D
i
i
i
D
I
i
i
i
i
x
D
D
n
n
n
n
n
n
a
a
a
a
a
a
C
C
C
C
"}
(24,1,1) = {"
C
C
C
C
a
a
a
a
a
a
n
n
n
n
n
n
D
x
i
D
i
i
D
D
i
D
i
D
i
i
i
D
i
D
i
D
D
D
D
x
D
D
D
D
n
n
n
a
a
a
a
a
a
a
C
C
C
C
"}
(25,1,1) = {"
C
C
C
C
a
a
a
a
a
a
n
n
n
n
n
D
D
x
i
D
D
i
i
i
i
D
i
D
i
D
D
D
i
i
i
i
i
J
i
x
D
D
D
D
n
n
a
a
a
a
a
a
a
a
C
C
C
C
"}
(26,1,1) = {"
C
C
C
a
a
a
a
a
a
n
n
n
n
n
D
D
D
x
d
i
D
D
D
D
D
D
d
D
i
i
i
D
D
D
D
D
D
B
d
x
D
D
D
D
n
n
a
a
a
a
a
a
N
a
C
C
C
C
"}
(27,1,1) = {"
C
C
a
a
a
a
a
n
n
n
n
n
n
n
D
D
D
x
D
i
D
i
i
i
i
i
m
D
D
D
G
i
i
i
i
m
D
D
D
x
D
D
D
D
n
n
n
n
a
a
a
a
a
a
C
C
C
C
"}
(28,1,1) = {"
C
C
a
a
a
n
n
n
n
n
n
n
n
n
D
D
D
x
Z
i
D
i
D
D
D
D
D
D
i
i
i
D
i
i
D
i
i
i
M
x
D
D
D
D
n
n
n
n
a
a
a
a
a
a
C
C
C
C
"}
(29,1,1) = {"
C
C
a
a
n
n
n
n
n
n
n
n
n
n
n
D
D
x
i
D
D
i
D
i
i
i
D
D
i
D
D
D
D
D
D
D
D
D
D
x
D
D
D
D
n
n
n
n
n
a
a
a
a
a
C
C
C
C
"}
(30,1,1) = {"
C
C
a
a
n
n
n
n
n
n
n
n
n
n
D
D
D
x
i
D
i
i
D
i
D
i
D
i
i
D
i
i
i
D
m
i
i
i
i
x
D
D
D
n
n
n
n
n
n
a
a
a
a
a
C
C
C
C
"}
(31,1,1) = {"
C
C
a
a
n
n
n
n
n
n
n
n
n
n
D
D
D
x
i
D
i
D
D
i
D
i
D
i
D
D
i
D
I
i
i
D
D
D
i
x
D
D
D
n
n
n
n
n
n
n
n
a
a
a
C
C
C
C
"}
(32,1,1) = {"
C
C
a
a
a
a
a
a
n
n
n
n
n
n
D
D
D
x
i
D
i
D
i
i
D
i
D
i
i
D
i
D
D
D
D
D
E
i
i
x
D
D
D
n
n
n
n
n
n
n
n
a
a
a
C
C
C
C
"}
(33,1,1) = {"
C
C
a
a
a
a
a
a
n
n
n
n
n
n
n
D
D
x
i
i
i
D
i
D
D
i
D
D
i
D
i
i
i
i
i
D
i
D
D
x
D
n
n
n
n
n
n
n
n
n
n
n
a
a
C
C
C
C
"}
(34,1,1) = {"
C
C
a
a
a
a
a
n
n
n
n
n
n
n
n
D
D
x
D
D
D
D
i
D
D
i
D
i
i
D
D
D
D
D
i
D
i
i
i
x
D
D
n
n
n
n
n
n
n
n
n
n
a
a
a
C
C
C
"}
(35,1,1) = {"
C
C
C
C
a
a
a
n
n
n
n
n
n
n
n
D
D
x
i
i
m
i
i
d
D
c
D
i
D
D
i
i
i
D
i
D
D
D
f
x
D
D
D
n
n
n
n
n
n
n
n
n
n
a
a
C
C
C
"}
(36,1,1) = {"
C
C
C
C
a
a
a
a
n
n
n
n
n
n
n
D
D
x
i
D
i
D
i
D
D
i
D
i
i
D
i
D
i
D
i
D
S
i
i
x
D
D
D
n
n
n
n
n
n
n
n
n
n
a
a
C
C
C
"}
(37,1,1) = {"
C
C
C
C
a
a
a
a
a
n
n
n
n
n
n
D
D
x
i
l
D
i
i
i
D
i
D
D
i
D
i
D
i
D
i
D
Q
i
m
x
D
D
D
n
n
n
n
n
n
n
n
n
n
a
a
a
C
C
"}
(38,1,1) = {"
C
C
C
C
a
a
a
a
a
a
n
n
n
n
n
n
D
x
i
D
i
D
G
D
D
i
D
i
i
i
i
D
i
D
i
D
d
i
Q
x
D
D
D
n
n
n
n
n
n
n
n
n
n
n
a
a
C
C
"}
(39,1,1) = {"
C
C
C
C
a
a
a
a
a
a
n
n
n
n
n
D
D
x
i
i
i
i
i
i
D
m
i
i
D
D
i
D
i
i
i
D
b
i
H
x
D
D
D
n
n
n
n
n
n
n
n
n
n
n
a
a
C
C
"}
(40,1,1) = {"
C
C
C
C
a
a
a
a
a
a
n
n
n
n
n
D
D
x
x
x
x
x
x
x
x
x
x
x
x
x
x
x
x
x
x
x
x
x
x
R
D
D
n
n
n
n
n
n
n
n
n
n
n
n
a
a
C
C
"}
(41,1,1) = {"
C
C
C
C
a
N
a
a
a
a
n
n
n
n
n
D
D
D
D
D
D
D
D
D
D
D
D
D
D
D
D
D
D
D
D
D
D
D
D
D
D
D
D
n
n
n
n
n
n
n
n
n
n
n
a
a
C
C
"}
(42,1,1) = {"
C
C
C
C
a
a
a
a
a
a
a
n
n
n
n
D
D
D
D
D
D
D
D
D
D
D
D
D
D
D
D
D
D
D
D
D
D
D
D
D
D
D
D
n
n
n
n
n
n
n
n
n
n
n
a
a
C
C
"}
(43,1,1) = {"
C
C
C
C
a
a
a
a
a
a
n
n
n
n
n
n
D
D
n
D
D
D
D
n
n
n
D
D
D
D
n
n
n
D
D
D
D
D
D
D
D
D
n
n
n
n
n
n
n
n
n
n
n
a
a
C
C
C
"}
(44,1,1) = {"
C
C
C
C
a
a
a
a
a
n
n
n
n
n
n
n
n
n
n
n
D
D
n
n
n
n
n
D
D
D
n
n
n
n
n
D
D
D
n
n
n
n
n
n
a
n
n
n
n
n
n
n
n
a
C
C
C
C
"}
(45,1,1) = {"
C
C
C
C
C
a
a
a
a
n
n
n
n
n
n
n
n
n
n
n
n
n
n
n
n
n
n
n
n
n
n
n
n
n
n
n
n
n
n
n
n
n
n
n
a
n
n
n
n
n
n
n
a
a
C
C
C
C
"}
(46,1,1) = {"
C
C
C
C
C
C
C
a
a
a
n
n
n
n
n
n
n
n
n
n
n
n
n
n
n
n
n
n
n
n
n
n
n
n
n
n
n
n
n
n
n
n
n
a
a
n
n
n
n
n
n
n
a
a
C
C
C
C
"}
(47,1,1) = {"
C
C
C
C
C
C
C
C
a
a
a
n
n
n
n
n
n
n
n
n
n
n
n
n
n
n
n
n
n
n
n
n
n
n
n
n
n
n
n
n
n
n
n
a
a
a
n
n
n
n
a
a
a
C
C
C
C
C
"}
(48,1,1) = {"
C
C
C
C
C
C
C
C
C
a
a
n
n
n
n
n
n
n
n
n
a
a
n
n
n
n
n
n
n
n
n
n
n
a
n
n
n
n
n
n
n
n
a
a
a
a
a
a
a
a
a
a
C
C
C
C
C
C
"}
(49,1,1) = {"
C
C
C
C
C
C
C
C
C
a
a
n
n
a
n
n
n
n
n
n
a
a
a
n
n
n
n
n
n
n
n
n
n
a
n
n
n
n
n
n
a
a
a
a
a
a
a
a
a
a
C
C
C
C
C
C
C
C
"}
(50,1,1) = {"
C
C
C
C
C
C
C
C
C
a
a
a
a
a
n
n
n
n
n
n
a
a
a
a
n
n
n
n
n
n
n
n
n
a
a
n
n
n
n
n
a
a
a
a
a
a
C
C
C
C
C
C
C
C
C
C
C
C
"}
(51,1,1) = {"
C
C
C
C
C
C
C
C
C
C
C
C
a
a
n
n
n
n
n
n
a
a
a
a
a
n
n
a
a
a
n
n
n
a
a
n
n
n
n
a
a
a
a
N
a
a
C
C
C
C
C
C
C
C
C
C
C
C
"}
(52,1,1) = {"
C
C
C
C
C
C
C
C
C
C
C
C
C
a
a
n
n
n
n
n
a
a
a
a
a
a
n
a
a
a
a
n
a
a
a
a
a
n
n
a
a
a
a
a
a
a
C
C
C
C
C
C
C
C
C
C
C
C
"}
(53,1,1) = {"
C
C
C
C
C
C
C
C
C
C
C
C
C
a
a
a
n
n
n
n
a
a
a
a
a
a
a
a
a
a
a
a
a
a
a
a
a
a
a
a
C
C
C
C
C
C
C
C
C
C
C
C
C
C
C
C
C
C
"}
(54,1,1) = {"
C
C
C
C
C
C
C
C
C
C
C
C
C
C
a
a
a
a
a
n
a
a
a
a
a
a
a
a
a
a
a
a
a
C
C
C
C
C
C
C
C
C
C
C
C
C
C
C
C
C
C
C
C
C
C
C
C
C
"}
(55,1,1) = {"
C
C
C
C
C
C
C
C
C
C
C
C
C
C
C
C
C
a
a
a
a
a
N
a
a
a
a
a
C
C
C
C
C
C
C
C
C
C
C
C
C
C
C
C
C
C
C
C
C
C
C
C
C
C
C
C
C
C
"}
(56,1,1) = {"
C
C
C
C
C
C
C
C
C
C
C
C
C
C
C
C
C
a
a
a
a
a
a
a
a
a
a
a
C
C
C
C
C
C
C
C
C
C
C
C
C
C
C
C
C
C
C
C
C
C
C
C
C
C
C
C
C
C
"}
(57,1,1) = {"
C
C
C
C
C
C
C
C
C
C
C
C
C
C
C
C
C
C
C
C
C
C
C
C
C
C
C
C
C
C
C
C
C
C
C
C
C
C
C
C
C
C
C
C
C
C
C
C
C
C
C
C
C
C
C
C
C
C
"}
(58,1,1) = {"
C
C
C
C
C
C
C
C
C
C
C
C
C
C
C
C
C
C
C
C
C
C
C
C
C
C
C
C
C
C
C
C
C
C
C
C
C
C
C
C
C
C
C
C
C
C
C
C
C
C
C
C
C
C
C
C
C
C
"}
