//MAP CONVERTED BY dmm2tgm.py THIS HEADER COMMENT PREVENTS RECONVERSION, DO NOT REMOVE
"a" = (
/turf/template_noop,
/area/template_noop)
"b" = (
/turf/space,
/area/submap/outpost21/asteroid_generic)
"c" = (
/turf/simulated/mineral/vacuum,
/area/submap/outpost21/asteroid_generic)
"d" = (
/turf/simulated/mineral/floor/vacuum,
/area/submap/outpost21/asteroid_generic)
"e" = (
/obj/structure/bonfire/permanent/sifwood,
/turf/simulated/mineral/floor/vacuum,
/area/submap/outpost21/asteroid_generic)
"f" = (
/mob/living/simple_mob/animal/space/bear,
/turf/simulated/mineral/floor/vacuum,
/area/submap/outpost21/asteroid_generic)
"g" = (
/obj/item/instrument/guitar,
/turf/simulated/mineral/floor/vacuum,
/area/submap/outpost21/asteroid_generic)
"h" = (
/obj/structure/loot_pile/surface/bones,
/obj/item/clothing/head/sombrero{
	pixel_y = 3;
	pixel_x = 4
	},
/turf/simulated/mineral/floor/vacuum,
/area/submap/outpost21/asteroid_generic)

(1,1,1) = {"
a
a
a
a
a
a
a
a
a
a
a
a
a
a
a
a
a
a
a
a
a
a
a
a
a
a
a
"}
(2,1,1) = {"
a
a
a
a
a
a
a
a
a
a
a
a
a
a
a
a
a
a
a
a
a
a
a
a
a
a
a
"}
(3,1,1) = {"
a
a
a
a
a
a
a
a
a
a
a
a
a
b
b
b
b
a
a
a
a
a
a
a
a
a
a
"}
(4,1,1) = {"
a
a
a
a
a
a
a
a
a
b
b
b
b
b
c
c
b
a
a
a
a
a
a
a
a
a
a
"}
(5,1,1) = {"
a
a
a
a
a
a
a
a
b
b
c
c
c
c
c
c
b
a
a
a
a
a
a
a
a
a
a
"}
(6,1,1) = {"
a
a
a
a
a
a
a
a
b
c
c
c
c
c
c
c
b
a
a
a
a
a
a
a
a
a
a
"}
(7,1,1) = {"
a
a
a
b
b
b
b
b
b
c
c
c
c
c
c
c
b
b
b
b
b
b
b
b
b
a
a
"}
(8,1,1) = {"
a
a
a
b
c
c
b
b
b
c
c
b
c
c
c
b
b
c
b
b
c
b
c
b
b
a
a
"}
(9,1,1) = {"
a
a
a
b
c
c
c
c
b
b
b
b
b
c
b
b
c
c
c
c
c
c
b
b
b
a
a
"}
(10,1,1) = {"
a
a
a
b
b
c
c
c
c
b
b
c
b
b
b
c
c
c
c
c
c
c
c
c
b
a
a
"}
(11,1,1) = {"
a
a
a
b
c
c
c
c
c
c
b
c
b
c
c
c
c
c
c
c
c
c
c
c
b
a
a
"}
(12,1,1) = {"
a
a
a
b
b
c
c
c
c
c
c
c
b
c
c
c
c
c
c
c
c
c
c
c
b
a
a
"}
(13,1,1) = {"
a
a
a
b
b
c
c
c
b
b
b
b
b
b
b
c
c
c
c
c
c
c
c
b
b
a
a
"}
(14,1,1) = {"
a
a
b
b
b
b
c
b
b
b
b
c
c
c
b
b
c
c
c
c
c
c
b
b
b
a
a
"}
(15,1,1) = {"
a
a
b
c
c
b
b
b
b
b
c
c
d
b
b
b
c
c
c
c
c
c
c
c
b
a
a
"}
(16,1,1) = {"
a
a
b
b
c
b
c
b
b
c
c
d
d
d
c
b
b
c
c
c
c
c
c
c
b
a
a
"}
(17,1,1) = {"
a
a
b
b
c
c
c
c
c
c
d
f
e
d
c
b
b
c
c
c
c
c
b
b
b
a
a
"}
(18,1,1) = {"
a
a
b
c
c
c
c
c
c
c
h
d
d
d
c
c
b
c
c
c
c
c
c
b
b
a
a
"}
(19,1,1) = {"
a
a
b
b
c
c
c
b
b
c
c
g
d
c
c
c
b
b
b
c
c
c
b
b
a
a
a
"}
(20,1,1) = {"
a
a
b
c
c
b
b
b
b
b
c
c
d
c
b
b
b
b
b
b
c
b
b
a
a
a
a
"}
(21,1,1) = {"
a
a
b
c
b
b
c
b
b
b
b
b
b
b
b
b
b
c
b
b
b
b
a
a
a
a
a
"}
(22,1,1) = {"
a
a
b
b
b
c
c
c
b
b
b
b
b
b
b
b
c
c
c
b
b
b
a
a
a
a
a
"}
(23,1,1) = {"
a
a
b
b
b
c
c
c
c
b
b
c
c
b
b
c
c
c
c
b
b
b
a
a
a
a
a
"}
(24,1,1) = {"
a
a
b
b
c
c
c
c
b
b
c
c
c
c
b
b
c
c
c
c
b
b
a
a
a
a
a
"}
(25,1,1) = {"
a
a
b
c
c
c
c
c
b
b
c
c
c
c
c
b
b
c
c
c
b
b
a
a
a
a
a
"}
(26,1,1) = {"
a
a
b
b
c
c
c
c
c
b
b
b
c
c
c
c
b
c
c
c
c
b
a
a
a
a
a
"}
(27,1,1) = {"
a
a
a
b
b
b
c
b
b
b
a
b
b
b
c
b
b
c
c
c
b
b
a
a
a
a
a
"}
(28,1,1) = {"
a
a
a
a
a
b
b
b
a
a
a
a
a
b
b
b
c
c
c
c
b
a
a
a
a
a
a
"}
(29,1,1) = {"
a
a
a
a
a
a
a
a
a
a
a
a
a
a
b
b
b
c
c
b
b
a
a
a
a
a
a
"}
(30,1,1) = {"
a
a
a
a
a
a
a
a
a
a
a
a
a
a
a
b
b
b
b
b
b
a
a
a
a
a
a
"}
(31,1,1) = {"
a
a
a
a
a
a
a
a
a
a
a
a
a
a
a
a
a
a
a
a
a
a
a
a
a
a
a
"}
(32,1,1) = {"
a
a
a
a
a
a
a
a
a
a
a
a
a
a
a
a
a
a
a
a
a
a
a
a
a
a
a
"}
