//MAP CONVERTED BY dmm2tgm.py THIS HEADER COMMENT PREVENTS RECONVERSION, DO NOT REMOVE
"a" = (
/turf/simulated/mineral/vacuum,
/area/submap/outpost21/asteroid_generic)
"N" = (
/turf/template_noop,
/area/submap/outpost21/asteroid_generic)
"S" = (
/turf/template_noop,
/area/template_noop)

(1,1,1) = {"
S
S
S
S
S
S
S
S
S
S
S
S
S
S
S
S
S
S
S
S
S
S
S
S
S
S
S
S
S
S
"}
(2,1,1) = {"
S
N
N
N
N
N
N
N
N
N
N
N
N
N
N
N
N
N
N
N
N
N
N
N
N
N
N
N
N
S
"}
(3,1,1) = {"
S
N
N
N
N
N
N
N
N
N
N
N
N
a
a
a
a
a
N
N
N
N
N
N
N
N
N
N
N
S
"}
(4,1,1) = {"
S
N
N
N
N
N
N
N
N
N
N
a
a
a
a
a
a
a
a
N
N
N
N
N
N
N
N
N
N
S
"}
(5,1,1) = {"
S
N
N
N
N
N
N
N
N
a
a
a
a
a
a
a
a
a
a
a
a
N
N
N
N
N
N
N
N
S
"}
(6,1,1) = {"
S
N
N
N
N
N
a
a
a
a
a
a
a
a
a
a
a
a
a
a
a
a
a
N
N
N
N
N
N
S
"}
(7,1,1) = {"
S
N
N
N
a
a
a
a
a
a
a
a
a
a
a
a
a
a
a
a
a
a
a
a
a
N
N
N
N
S
"}
(8,1,1) = {"
S
N
N
a
a
a
a
a
a
a
a
a
a
a
a
a
a
a
a
a
a
a
a
a
a
a
N
N
N
S
"}
(9,1,1) = {"
S
N
N
a
a
a
a
a
a
a
a
a
a
a
a
a
a
a
a
a
a
a
a
a
a
a
N
N
N
S
"}
(10,1,1) = {"
S
N
a
a
a
a
a
a
a
a
a
a
a
a
a
a
a
a
a
a
a
a
a
a
a
a
a
N
N
S
"}
(11,1,1) = {"
S
N
a
a
a
a
a
a
a
a
a
a
a
a
a
a
a
a
a
a
a
a
a
a
a
a
a
a
N
S
"}
(12,1,1) = {"
S
N
a
a
a
a
a
a
a
a
a
a
a
a
a
a
a
a
a
a
a
a
a
a
a
a
a
a
N
S
"}
(13,1,1) = {"
S
N
N
a
a
a
a
a
a
a
a
a
a
a
a
a
a
a
a
a
a
a
a
a
a
a
a
a
a
S
"}
(14,1,1) = {"
S
N
N
N
a
a
a
a
a
a
a
a
a
a
a
a
a
a
a
a
a
a
a
a
a
a
a
a
a
S
"}
(15,1,1) = {"
S
N
N
N
a
a
a
a
a
a
a
a
a
a
a
a
a
a
a
a
a
a
a
a
a
a
a
a
a
S
"}
(16,1,1) = {"
S
N
N
N
a
a
a
a
a
a
a
a
a
a
a
a
a
a
a
a
a
a
a
a
a
a
a
a
a
S
"}
(17,1,1) = {"
S
N
N
N
a
a
a
a
a
a
a
a
a
a
a
a
a
a
a
a
a
a
a
a
a
a
a
a
N
S
"}
(18,1,1) = {"
S
N
N
a
a
a
a
a
a
a
a
a
a
a
a
a
a
a
a
a
a
a
a
a
a
a
a
a
a
S
"}
(19,1,1) = {"
S
N
N
a
a
a
a
a
a
a
a
a
a
a
a
a
a
a
a
a
a
a
a
a
a
a
a
a
a
S
"}
(20,1,1) = {"
S
N
N
a
a
a
a
a
a
a
a
a
a
a
a
a
a
a
a
a
a
a
a
a
a
a
a
a
a
S
"}
(21,1,1) = {"
S
N
N
N
a
a
a
a
a
a
a
a
a
a
a
a
a
a
a
a
a
a
a
a
a
a
a
a
N
S
"}
(22,1,1) = {"
S
N
N
N
a
a
a
a
a
a
a
a
a
a
a
a
a
a
a
a
a
a
a
a
a
a
a
a
N
S
"}
(23,1,1) = {"
S
N
N
N
N
a
a
a
a
a
a
a
a
a
a
a
a
a
a
a
a
a
a
a
a
a
a
a
N
S
"}
(24,1,1) = {"
S
N
N
N
N
a
a
a
a
a
a
a
a
a
a
a
a
a
a
a
a
a
a
a
a
a
a
N
N
S
"}
(25,1,1) = {"
S
N
N
N
N
N
a
a
a
a
a
a
a
a
a
a
a
a
a
a
a
a
a
a
a
a
a
N
N
S
"}
(26,1,1) = {"
S
N
N
N
N
N
N
a
a
a
a
a
a
a
a
a
a
a
a
N
N
a
a
a
a
a
a
a
N
S
"}
(27,1,1) = {"
S
N
N
N
N
N
N
a
a
a
a
a
a
a
a
a
N
N
N
N
N
N
N
a
a
a
a
a
N
S
"}
(28,1,1) = {"
S
N
N
N
N
N
N
N
N
a
a
a
a
a
a
N
N
N
N
N
N
N
N
N
a
a
a
N
N
S
"}
(29,1,1) = {"
S
N
N
N
N
N
N
N
N
N
N
N
N
N
N
N
N
N
N
N
N
N
N
N
N
N
N
N
N
S
"}
(30,1,1) = {"
S
S
S
S
S
S
S
S
S
S
S
S
S
S
S
S
S
S
S
S
S
S
S
S
S
S
S
S
S
S
"}
