//MAP CONVERTED BY dmm2tgm.py THIS HEADER COMMENT PREVENTS RECONVERSION, DO NOT REMOVE
"a" = (
/turf/simulated/mineral/vacuum,
/area/submap/outpost21/asteroid_generic)
"t" = (
/turf/template_noop,
/area/template_noop)
"J" = (
/turf/template_noop,
/area/submap/outpost21/asteroid_generic)

(1,1,1) = {"
t
t
t
t
t
t
t
t
t
t
t
t
t
t
t
"}
(2,1,1) = {"
t
J
J
J
J
J
J
J
J
J
J
J
J
J
t
"}
(3,1,1) = {"
t
J
J
J
J
a
a
a
a
J
J
J
J
J
t
"}
(4,1,1) = {"
t
J
J
a
a
a
a
a
a
a
J
J
J
J
t
"}
(5,1,1) = {"
t
J
J
a
a
a
a
a
a
a
a
J
J
J
t
"}
(6,1,1) = {"
t
J
a
a
a
a
a
a
a
a
a
a
J
J
t
"}
(7,1,1) = {"
t
J
a
a
a
a
a
a
a
a
a
a
a
J
t
"}
(8,1,1) = {"
t
J
a
a
a
a
a
a
a
a
a
a
a
J
t
"}
(9,1,1) = {"
t
J
J
a
a
a
a
a
a
a
a
a
a
J
t
"}
(10,1,1) = {"
t
J
J
a
a
a
a
a
a
a
a
a
J
J
t
"}
(11,1,1) = {"
t
J
J
J
a
a
a
a
a
a
a
J
J
J
t
"}
(12,1,1) = {"
t
J
J
J
J
a
a
a
a
a
a
J
J
J
t
"}
(13,1,1) = {"
t
J
J
J
J
J
J
J
J
J
J
J
J
J
t
"}
(14,1,1) = {"
t
J
J
J
J
J
J
J
J
J
J
J
J
J
t
"}
(15,1,1) = {"
t
t
t
t
t
t
t
t
t
t
t
t
t
t
t
"}
