//MAP CONVERTED BY dmm2tgm.py THIS HEADER COMMENT PREVENTS RECONVERSION, DO NOT REMOVE
"a" = (
/turf/template_noop,
/area/submap/outpost21/asteroid_generic)
"G" = (
/turf/template_noop,
/area/template_noop)
"J" = (
/turf/simulated/mineral/vacuum,
/area/submap/outpost21/asteroid_generic)

(1,1,1) = {"
G
G
G
G
G
G
G
G
G
G
G
G
G
G
G
G
G
G
G
G
"}
(2,1,1) = {"
G
a
a
a
a
a
a
a
a
a
a
a
a
a
a
a
a
a
a
G
"}
(3,1,1) = {"
G
a
a
a
a
J
J
J
J
a
a
a
a
a
a
a
a
a
a
G
"}
(4,1,1) = {"
G
a
a
a
J
J
J
J
J
J
a
a
a
a
a
a
a
a
a
G
"}
(5,1,1) = {"
G
a
a
a
J
J
J
J
J
J
J
a
a
a
a
a
a
a
a
G
"}
(6,1,1) = {"
G
a
a
a
J
J
J
J
J
J
J
J
a
a
a
a
a
a
a
G
"}
(7,1,1) = {"
G
a
a
a
J
J
J
J
J
J
J
J
a
a
a
a
a
a
a
G
"}
(8,1,1) = {"
G
a
a
a
a
J
J
J
J
J
J
J
a
a
a
a
a
a
a
G
"}
(9,1,1) = {"
G
a
a
a
a
a
J
J
J
J
a
a
a
a
a
J
J
a
a
G
"}
(10,1,1) = {"
G
a
a
a
a
a
a
a
a
a
a
a
J
J
J
J
J
J
a
G
"}
(11,1,1) = {"
G
a
a
a
a
a
a
a
a
a
a
J
J
J
J
J
J
J
a
G
"}
(12,1,1) = {"
G
a
a
a
a
a
J
J
J
a
a
J
J
J
J
J
J
J
a
G
"}
(13,1,1) = {"
G
a
a
a
a
J
J
J
J
J
a
J
J
J
J
J
J
J
a
G
"}
(14,1,1) = {"
G
a
a
J
J
J
J
J
J
J
a
J
J
J
J
J
J
J
a
G
"}
(15,1,1) = {"
G
a
J
J
J
J
J
J
J
J
a
J
J
J
J
J
J
J
a
G
"}
(16,1,1) = {"
G
a
J
J
J
J
J
J
J
J
a
a
J
J
J
J
J
J
a
G
"}
(17,1,1) = {"
G
a
a
J
J
J
J
J
J
J
a
a
J
J
J
J
J
a
a
G
"}
(18,1,1) = {"
G
a
a
a
a
J
J
J
J
a
a
a
a
a
a
a
a
a
a
G
"}
(19,1,1) = {"
G
a
a
a
a
a
a
a
a
a
a
a
a
a
a
a
a
a
a
G
"}
(20,1,1) = {"
G
G
G
G
G
G
G
G
G
G
G
G
G
G
G
G
G
G
G
G
"}
