//MAP CONVERTED BY dmm2tgm.py THIS HEADER COMMENT PREVENTS RECONVERSION, DO NOT REMOVE
"a" = (
/turf/template_noop,
/area/template_noop)
"b" = (
/turf/template_noop,
/area/submap/outpost21/asteroid_generic)
"c" = (
/turf/simulated/wall/bay/steel,
/area/submap/outpost21/asteroid_generic)
"d" = (
/obj/structure/table/rack/shelf/steel,
/obj/random/maintenance,
/turf/simulated/floor/plating,
/area/submap/outpost21/asteroid_generic)
"e" = (
/obj/structure/table/rack/shelf/steel,
/obj/random/maintenance,
/obj/random/junk,
/turf/simulated/floor/plating,
/area/submap/outpost21/asteroid_generic)
"f" = (
/obj/structure/closet/crate,
/obj/random/maintenance,
/obj/random/maintenance,
/obj/random/maintenance,
/obj/random/maintenance,
/obj/random/maintenance,
/obj/random/maintenance,
/obj/random/maintenance,
/obj/random/maintenance,
/turf/simulated/floor/plating,
/area/submap/outpost21/asteroid_generic)
"g" = (
/obj/machinery/door/airlock/angled_bay/standard/color/cargo{
	dir = 4;
	name = "Cargo Container"
	},
/turf/simulated/floor/plating,
/area/submap/outpost21/asteroid_generic)
"i" = (
/obj/random/junk,
/turf/simulated/floor/plating,
/area/submap/outpost21/asteroid_generic)
"j" = (
/turf/simulated/floor/plating,
/area/submap/outpost21/asteroid_generic)
"k" = (
/obj/structure/closet/crate,
/obj/random/maintenance,
/obj/random/maintenance,
/obj/random/maintenance,
/obj/random/maintenance,
/obj/random/maintenance,
/obj/random/maintenance,
/obj/random/maintenance,
/obj/random/junk,
/turf/simulated/floor/plating,
/area/submap/outpost21/asteroid_generic)
"o" = (
/obj/random/maintenance,
/turf/space,
/area/submap/outpost21/asteroid_generic)
"x" = (
/obj/structure/table/rack/shelf/steel,
/obj/random/maintenance,
/obj/item/tank/vox,
/turf/simulated/floor/plating,
/area/submap/outpost21/asteroid_generic)
"N" = (
/obj/item/tank/oxygen,
/turf/simulated/floor/plating,
/area/submap/outpost21/asteroid_generic)
"R" = (
/obj/random/junk,
/turf/space,
/area/submap/outpost21/asteroid_generic)
"T" = (
/turf/space,
/area/submap/outpost21/asteroid_generic)
"Z" = (
/obj/item/tank/emergency/nitrogen,
/turf/simulated/floor/plating,
/area/submap/outpost21/asteroid_generic)

(1,1,1) = {"
a
a
a
a
a
a
a
a
a
"}
(2,1,1) = {"
a
b
c
c
g
c
c
b
a
"}
(3,1,1) = {"
a
R
c
d
j
x
c
b
a
"}
(4,1,1) = {"
a
T
c
e
i
d
c
T
a
"}
(5,1,1) = {"
a
o
c
d
j
j
c
R
a
"}
(6,1,1) = {"
a
b
c
N
j
d
c
o
a
"}
(7,1,1) = {"
a
b
c
f
Z
k
c
b
a
"}
(8,1,1) = {"
a
b
c
c
c
c
c
b
a
"}
(9,1,1) = {"
a
a
a
a
a
a
a
a
a
"}
