//MAP CONVERTED BY dmm2tgm.py THIS HEADER COMMENT PREVENTS RECONVERSION, DO NOT REMOVE
"a" = (
/turf/template_noop,
/area/template_noop)
"b" = (
/turf/template_noop,
/area/submap/outpost21/asteroid_generic)
"c" = (
/obj/structure/table/rack/shelf/steel,
/obj/random/contraband,
/obj/random/contraband,
/turf/simulated/floor/plating,
/area/submap/outpost21/asteroid_generic)
"f" = (
/turf/simulated/wall/bay/steel,
/area/submap/outpost21/asteroid_generic)
"g" = (
/obj/structure/table/rack/shelf/steel,
/obj/random/multiple/ore_pile,
/turf/simulated/floor/plating,
/area/submap/outpost21/asteroid_generic)
"h" = (
/obj/structure/table/rack/shelf/steel,
/obj/random/maintenance/engineering,
/turf/simulated/floor/plating,
/area/submap/outpost21/asteroid_generic)
"i" = (
/obj/random/contraband,
/turf/simulated/floor/plating,
/area/submap/outpost21/asteroid_generic)
"j" = (
/obj/structure/closet/crate,
/obj/random/gun/random,
/obj/random/contraband,
/obj/random/contraband,
/obj/random/contraband,
/obj/random/contraband,
/turf/simulated/floor/plating,
/area/submap/outpost21/asteroid_generic)
"k" = (
/obj/machinery/door/airlock/angled_bay/standard/color/cargo{
	name = "Cargo Container";
	dir = 4
	},
/turf/simulated/floor/plating,
/area/submap/outpost21/asteroid_generic)
"l" = (
/turf/simulated/floor/plating,
/area/submap/outpost21/asteroid_generic)
"m" = (
/obj/random/drinkbottle,
/obj/random/drinkbottle,
/turf/simulated/floor/plating,
/area/submap/outpost21/asteroid_generic)
"n" = (
/obj/random/mre,
/turf/simulated/floor/plating,
/area/submap/outpost21/asteroid_generic)
"o" = (
/obj/structure/table/rack/shelf/steel,
/obj/random/material/precious,
/obj/random/material/precious,
/obj/random/material/precious,
/obj/random/material/precious,
/obj/random/material/precious,
/obj/random/material/precious,
/turf/simulated/floor/plating,
/area/submap/outpost21/asteroid_generic)
"p" = (
/obj/random/maintenance/medical,
/obj/structure/closet/crate,
/obj/random/contraband,
/turf/simulated/floor/plating,
/area/submap/outpost21/asteroid_generic)

(1,1,1) = {"
a
a
a
a
a
a
a
a
a
"}
(2,1,1) = {"
a
b
f
f
k
f
f
b
a
"}
(3,1,1) = {"
a
b
f
c
l
o
f
b
a
"}
(4,1,1) = {"
a
b
f
h
l
o
f
b
a
"}
(5,1,1) = {"
a
b
f
h
l
m
f
b
a
"}
(6,1,1) = {"
a
b
f
i
n
g
f
b
a
"}
(7,1,1) = {"
a
b
f
j
l
p
f
b
a
"}
(8,1,1) = {"
a
b
f
f
f
f
f
b
a
"}
(9,1,1) = {"
a
a
a
a
a
a
a
a
a
"}
