//MAP CONVERTED BY dmm2tgm.py THIS HEADER COMMENT PREVENTS RECONVERSION, DO NOT REMOVE
"bp" = (
/mob/living/carbon/alien/diona,
/turf/simulated/floor/diona,
/area/submap/outpost21/structure_generic)
"bB" = (
/turf/simulated/wall/diona,
/area/submap/outpost21/structure_generic)
"eh" = (
/turf/template_noop,
/area/template_noop)
"er" = (
/mob/living/carbon/alien/diona,
/turf/simulated/mineral/floor/ignore_cavegen/cave,
/area/submap/outpost21/structure_generic)
"jD" = (
/obj/random/plushie,
/turf/simulated/floor/diona,
/area/submap/outpost21/structure_generic)
"lk" = (
/obj/structure/flora/lily1,
/obj/random/powercell,
/turf/simulated/floor/diona,
/area/submap/outpost21/structure_generic)
"ne" = (
/obj/structure/flora/lily1,
/turf/simulated/floor/diona,
/area/submap/outpost21/structure_generic)
"nt" = (
/obj/structure/diona/bulb/sea_of_stars{
	pixel_y = 6
	},
/obj/structure/flora/underwater/grass1,
/turf/simulated/floor/diona,
/area/submap/outpost21/structure_generic)
"oK" = (
/mob/living/carbon/alien/diona,
/obj/random/maintenance/research,
/turf/simulated/floor/diona,
/area/submap/outpost21/structure_generic)
"pt" = (
/obj/random/material/precious,
/turf/simulated/floor/diona,
/area/submap/outpost21/structure_generic)
"pV" = (
/obj/structure/flora/lily1,
/obj/random/tool/alien,
/turf/simulated/floor/diona,
/area/submap/outpost21/structure_generic)
"qA" = (
/obj/structure/flora/underwater/grass1,
/turf/simulated/floor/diona,
/area/submap/outpost21/structure_generic)
"qS" = (
/obj/random/maintenance/research,
/turf/simulated/mineral/floor/ignore_cavegen/cave,
/area/submap/outpost21/structure_generic)
"sK" = (
/obj/structure/flora/underwater/plant4,
/turf/simulated/floor/diona,
/area/submap/outpost21/structure_generic)
"tJ" = (
/mob/living/carbon/alien/diona,
/obj/random/material/precious,
/turf/simulated/floor/diona,
/area/submap/outpost21/structure_generic)
"wP" = (
/obj/structure/diona/vines,
/turf/simulated/floor/diona,
/area/submap/outpost21/structure_generic)
"zb" = (
/obj/structure/flora/tree/jungle_small,
/turf/simulated/mineral/floor/ignore_cavegen/cave,
/area/submap/outpost21/structure_generic)
"zz" = (
/obj/structure/flora/lily3,
/obj/random/mega_nukies,
/turf/simulated/floor/diona,
/area/submap/outpost21/structure_generic)
"BG" = (
/turf/simulated/mineral/floor/dirt,
/area/submap/outpost21/structure_generic)
"FP" = (
/obj/structure/flora/tree/jungle{
	pixel_y = -22
	},
/obj/structure/flora/underwater/grass1,
/turf/simulated/floor/diona,
/area/submap/outpost21/structure_generic)
"GY" = (
/obj/structure/diona/bulb,
/turf/simulated/floor/diona,
/area/submap/outpost21/structure_generic)
"Id" = (
/obj/structure/flora/underwater/grass4,
/obj/random/tool/alien,
/turf/simulated/floor/diona,
/area/submap/outpost21/structure_generic)
"Is" = (
/obj/machinery/portable_atmospherics/hydroponics/soil,
/turf/simulated/mineral/floor/ignore_cavegen/cave,
/area/submap/outpost21/structure_generic)
"Jb" = (
/turf/template_noop,
/area/submap/outpost21/structure_generic)
"Jx" = (
/obj/random/maintenance/research,
/turf/simulated/floor/diona,
/area/submap/outpost21/structure_generic)
"JM" = (
/turf/simulated/mineral/floor/ignore_cavegen/cave,
/area/submap/outpost21/structure_generic)
"Mq" = (
/obj/random/outcrop,
/turf/simulated/mineral/floor/ignore_cavegen/cave,
/area/submap/outpost21/structure_generic)
"Nh" = (
/obj/random/maintenance/cargo,
/turf/simulated/floor/diona,
/area/submap/outpost21/structure_generic)
"SM" = (
/obj/random/maintenance/cargo,
/turf/simulated/mineral/floor/ignore_cavegen/cave,
/area/submap/outpost21/structure_generic)
"Tp" = (
/obj/random/maintenance,
/turf/simulated/floor/diona,
/area/submap/outpost21/structure_generic)
"TQ" = (
/obj/structure/flora/lily1,
/obj/random/contraband,
/turf/simulated/floor/diona,
/area/submap/outpost21/structure_generic)
"TY" = (
/obj/structure/flora/underwater/plant2,
/turf/simulated/floor/diona,
/area/submap/outpost21/structure_generic)
"Uw" = (
/turf/simulated/mineral/vacuum,
/area/submap/outpost21/structure_generic)
"Uz" = (
/obj/structure/flora/underwater/grass4,
/turf/simulated/floor/diona,
/area/submap/outpost21/structure_generic)
"WS" = (
/obj/structure/flora/underwater/plant1,
/turf/simulated/floor/diona,
/area/submap/outpost21/structure_generic)
"WZ" = (
/obj/structure/flora/lily3,
/turf/simulated/floor/diona,
/area/submap/outpost21/structure_generic)
"Yc" = (
/obj/structure/flora/underwater/grass1,
/obj/random/tool/alien,
/turf/simulated/floor/diona,
/area/submap/outpost21/structure_generic)
"YO" = (
/obj/structure/flora/underwater/grass4,
/obj/random/powercell,
/turf/simulated/floor/diona,
/area/submap/outpost21/structure_generic)
"YR" = (
/mob/living/carbon/alien/diona,
/obj/structure/flora/lily1,
/turf/simulated/floor/diona,
/area/submap/outpost21/structure_generic)
"YT" = (
/turf/simulated/floor/diona,
/area/submap/outpost21/structure_generic)

(1,1,1) = {"
eh
eh
eh
eh
eh
eh
eh
eh
eh
eh
eh
eh
eh
eh
eh
eh
eh
eh
eh
eh
eh
eh
eh
eh
eh
eh
eh
eh
eh
eh
eh
eh
eh
eh
eh
eh
eh
eh
eh
eh
"}
(2,1,1) = {"
eh
Jb
Jb
Jb
Jb
Jb
Jb
Jb
Jb
Jb
Jb
Jb
Jb
Jb
Jb
Jb
Jb
Jb
Jb
Jb
Jb
Jb
Jb
Jb
Jb
Jb
Jb
Jb
Jb
Jb
Jb
Jb
Jb
Jb
Jb
Jb
Jb
Jb
Jb
eh
"}
(3,1,1) = {"
eh
Jb
Jb
Jb
Jb
Jb
Jb
Jb
Jb
Jb
Jb
Jb
Jb
Jb
Jb
Jb
Jb
Jb
Jb
Jb
Uw
Uw
Uw
Jb
Jb
Jb
Jb
Jb
Jb
Jb
Jb
Jb
Jb
Jb
Jb
Jb
Jb
Jb
Jb
eh
"}
(4,1,1) = {"
eh
Jb
Jb
Jb
Jb
Jb
Jb
Jb
Jb
Jb
Jb
Jb
Jb
Jb
Jb
Jb
Jb
Jb
Jb
Jb
Uw
Uw
Uw
Uw
Jb
Jb
Jb
Jb
Jb
Jb
Jb
Jb
Uw
Uw
Jb
Jb
Jb
Jb
Jb
eh
"}
(5,1,1) = {"
eh
Jb
Jb
Jb
Jb
Jb
Jb
Jb
Jb
Jb
Jb
Jb
Jb
Jb
Jb
Jb
bB
Jb
bB
Jb
Jb
Jb
Uw
Uw
Jb
Jb
Jb
Jb
bB
Jb
Jb
Jb
Uw
Uw
Uw
Jb
Jb
Jb
Jb
eh
"}
(6,1,1) = {"
eh
Jb
Jb
Jb
Jb
Jb
Jb
Jb
Jb
Jb
Jb
Jb
Jb
Jb
Jb
bB
bB
bB
bB
bB
Jb
Jb
Jb
Jb
Jb
Jb
Jb
bB
bB
Jb
Jb
Uw
Uw
Uw
Uw
Uw
Jb
Jb
Jb
eh
"}
(7,1,1) = {"
eh
Jb
bB
Jb
Jb
Jb
Jb
Jb
Jb
Jb
Jb
Jb
Jb
Jb
Jb
bB
YT
YT
WS
bB
Jb
Jb
Jb
Jb
Jb
Jb
Jb
bB
bB
Jb
Jb
Uw
Uw
Uw
Uw
Uw
Jb
Jb
Jb
eh
"}
(8,1,1) = {"
eh
bB
bB
Jb
Jb
Jb
Jb
Jb
Jb
Jb
Jb
Jb
Jb
Jb
bB
bB
Uz
YT
YT
bB
bB
bB
Jb
Jb
bB
bB
bB
bB
bB
Jb
Jb
Uw
Uw
Uw
Uw
Jb
Jb
Jb
Jb
eh
"}
(9,1,1) = {"
eh
bB
bB
bB
Jb
Jb
Jb
Jb
Jb
Jb
Jb
bB
bB
bB
bB
bB
bB
bB
bB
bB
bB
bB
bB
bB
bB
bB
bB
bB
Jb
Jb
Jb
Jb
Uw
Uw
Uw
Jb
Jb
Jb
Jb
eh
"}
(10,1,1) = {"
eh
Jb
bB
bB
Jb
Jb
Jb
Jb
bB
bB
bB
bB
bB
bB
bB
bB
WS
YT
Uz
bB
bB
ne
bB
bB
zz
GY
bB
bB
Jb
Jb
Jb
Jb
Jb
Jb
Jb
Jb
Jb
Jb
Jb
eh
"}
(11,1,1) = {"
eh
Jb
bB
bB
bB
Jb
Jb
Jb
bB
bB
bB
bB
WZ
YT
YT
Nh
YT
YT
YT
bB
YT
Tp
YT
YT
YT
Id
bB
bB
Jb
Jb
Jb
Jb
Jb
Jb
Jb
Jb
Jb
Jb
Jb
eh
"}
(12,1,1) = {"
eh
Jb
Jb
bB
bB
bB
bB
bB
bB
WS
pV
bB
bB
Uz
Is
JM
GY
Nh
YT
wP
YT
YT
WS
Tp
YT
bB
bB
bB
bB
Jb
Jb
Jb
Jb
Jb
Jb
Jb
Jb
Jb
Jb
eh
"}
(13,1,1) = {"
eh
Jb
Jb
bB
bB
GY
Yc
bB
bB
YT
jD
bB
bB
YT
zb
er
JM
Is
YT
bB
bB
bB
bB
ne
bp
YT
bB
bB
bB
bB
Jb
Jb
Jb
Jb
Jb
Jb
Jb
Jb
Jb
eh
"}
(14,1,1) = {"
eh
Jb
Jb
Jb
bB
sK
ne
YT
pt
bp
pt
YT
bB
bB
YT
SM
Is
YT
YT
bB
bB
bB
bB
bB
bB
YT
TY
WZ
bB
bB
Jb
Jb
Jb
Jb
Jb
Jb
Jb
Jb
Jb
eh
"}
(15,1,1) = {"
eh
Jb
Jb
bB
bB
bB
pt
YT
JM
Is
JM
YT
bB
bB
qA
YT
YT
bB
wP
bB
ne
GY
bB
bB
bB
bB
YT
qA
bB
bB
Jb
Jb
Jb
Jb
Jb
Jb
Jb
Jb
Jb
eh
"}
(16,1,1) = {"
eh
Jb
Jb
bB
bB
bB
YT
Is
JM
JM
tJ
YT
pt
bB
YT
YT
bB
bB
YT
YT
YT
sK
YT
WZ
bB
bB
bB
YT
bB
bB
Jb
Jb
Jb
Jb
Jb
Jb
Jb
Jb
Jb
eh
"}
(17,1,1) = {"
eh
Jb
Jb
bB
bB
sK
YT
zb
Is
YT
YT
YT
YT
wP
YT
YT
bB
bB
YT
YT
Uz
JM
er
YT
GY
bB
bB
wP
bB
bB
bB
bB
bB
bB
Jb
Jb
Jb
Jb
Jb
eh
"}
(18,1,1) = {"
eh
Jb
Jb
bB
bB
WZ
YT
bp
YT
ne
bB
bB
bB
bB
bB
YT
bB
bB
WZ
YT
er
JM
JM
JM
YT
ne
bB
YT
ne
bB
bB
bB
bB
bB
bB
Jb
Jb
Jb
Jb
eh
"}
(19,1,1) = {"
eh
Jb
Jb
bB
bB
bB
bB
YT
YT
YT
bB
bB
bB
bB
bB
wP
bB
bB
GY
YT
JM
FP
nt
JM
er
YT
wP
YT
YT
bB
bB
bB
Jb
Jb
Jb
Jb
Jb
Jb
Jb
eh
"}
(20,1,1) = {"
eh
Jb
Jb
bB
bB
bB
bB
TY
YT
qA
bB
bB
bB
YT
ne
YT
bB
bB
bB
YT
JM
JM
JM
JM
JM
WS
bB
bp
Uz
bB
bB
Jb
Jb
Jb
Jb
Jb
Jb
Jb
Jb
eh
"}
(21,1,1) = {"
eh
Jb
bB
bB
YT
Uz
bB
bB
wP
bB
bB
bB
YT
Is
er
JM
YT
bB
bB
ne
YT
JM
er
JM
JM
GY
bB
YT
sK
bB
bB
Jb
Jb
Jb
Jb
Jb
Jb
Jb
Jb
eh
"}
(22,1,1) = {"
eh
Jb
Jb
bB
YT
YT
bB
YT
YT
bB
bB
WZ
BG
zb
JM
Is
YT
TY
bB
bB
GY
YT
JM
JM
qA
bB
bB
YT
WZ
bB
bB
Jb
Jb
Jb
Jb
Jb
Jb
Jb
Jb
eh
"}
(23,1,1) = {"
eh
Jb
bB
bB
WS
bB
bB
ne
YT
bB
YT
YT
GY
JM
YT
YT
YT
bB
bB
bB
bB
ne
sK
GY
ne
bB
bB
YT
bB
bB
bB
Jb
Jb
Jb
Jb
Jb
Jb
Jb
Jb
eh
"}
(24,1,1) = {"
eh
Jb
Jb
bB
bB
bB
WZ
YT
Tp
wP
YT
YT
YT
YT
bB
wP
bB
bB
bB
bB
bB
bB
WZ
bB
bB
bB
bB
wP
bB
bB
bB
bB
Jb
Jb
Jb
Jb
Jb
Jb
Jb
eh
"}
(25,1,1) = {"
eh
Jb
Jb
Jb
bB
bB
GY
WS
bB
bB
zz
YR
sK
bB
bB
YT
YT
YT
bB
bB
bB
bB
bB
bB
bB
bB
YT
YT
bB
Uz
YT
bB
bB
Jb
Jb
Jb
Jb
Jb
Jb
eh
"}
(26,1,1) = {"
eh
Jb
Jb
bB
bB
bB
bB
bB
bB
bB
bB
bB
bB
bB
bB
Uz
YT
TQ
YT
YT
bB
bB
bB
YO
TY
qS
Is
YT
bB
YT
YT
bB
Jb
Jb
Jb
Jb
Jb
Jb
Jb
eh
"}
(27,1,1) = {"
eh
Jb
bB
bB
bB
bB
Jb
Jb
bB
bB
bB
bB
bB
bB
bB
bB
WS
YT
oK
YT
YT
wP
YT
YT
Is
er
Mq
YT
bB
bB
WS
bB
bB
Jb
Jb
Jb
Jb
Jb
Jb
eh
"}
(28,1,1) = {"
eh
Jb
bB
bB
Jb
Jb
Jb
Jb
Jb
Jb
Jb
bB
bB
bB
bB
bB
bB
bB
YT
Jx
YT
bB
YT
YT
zb
Is
YT
Jx
GY
bB
bB
bB
Jb
Jb
Jb
Jb
Jb
Jb
Jb
eh
"}
(29,1,1) = {"
eh
Jb
bB
Jb
Jb
Jb
Jb
Jb
Jb
Jb
Jb
Jb
Jb
Jb
bB
bB
bB
bB
bB
TQ
YT
bB
bB
sK
WZ
lk
bB
bB
bB
bB
bB
bB
bB
Jb
Jb
Jb
Jb
Jb
Jb
eh
"}
(30,1,1) = {"
eh
Jb
Jb
Jb
Jb
Jb
Jb
Jb
Jb
Jb
Jb
Jb
Jb
Jb
Jb
Jb
bB
bB
bB
bB
YT
jD
bB
bB
bB
bB
bB
bB
bB
bB
Jb
bB
bB
bB
Jb
Jb
Jb
Jb
Jb
eh
"}
(31,1,1) = {"
eh
Jb
Jb
Jb
Jb
Jb
Jb
Uw
Jb
Jb
Jb
Jb
Jb
Jb
Jb
Jb
Jb
bB
bB
bB
sK
oK
TY
bB
bB
bB
bB
Jb
Jb
Jb
Jb
Jb
Jb
Jb
Jb
Jb
Jb
Jb
Jb
eh
"}
(32,1,1) = {"
eh
Jb
Jb
Jb
Jb
Uw
Uw
Uw
Uw
Jb
Jb
Jb
Jb
Jb
Jb
Jb
Jb
Jb
Jb
bB
YO
YT
WZ
bB
Jb
Jb
Jb
Jb
Jb
Jb
Jb
Jb
Jb
Uw
Uw
Uw
Jb
Jb
Jb
eh
"}
(33,1,1) = {"
eh
Jb
Jb
Jb
Jb
Uw
Uw
Uw
Uw
Jb
Jb
Jb
Jb
Jb
Jb
Jb
Jb
Jb
Jb
bB
bB
GY
bB
bB
Jb
Jb
Jb
Jb
Jb
Jb
Jb
Jb
Jb
Uw
Uw
Uw
Uw
Jb
Jb
eh
"}
(34,1,1) = {"
eh
Jb
Jb
Jb
Jb
Uw
Uw
Uw
Jb
Jb
Jb
Jb
Jb
Jb
Jb
Jb
Jb
Jb
Jb
Jb
bB
bB
bB
Jb
Jb
Jb
Jb
Jb
Jb
Jb
Jb
Jb
Jb
Uw
Uw
Uw
Uw
Uw
Jb
eh
"}
(35,1,1) = {"
eh
Jb
Jb
Jb
Jb
Uw
Uw
Jb
Jb
Jb
Jb
Jb
Jb
Jb
Jb
Jb
Jb
Jb
Jb
Jb
Jb
bB
bB
Jb
Jb
Jb
Jb
Jb
Jb
Jb
Jb
Jb
Jb
Jb
Uw
Uw
Uw
Uw
Jb
eh
"}
(36,1,1) = {"
eh
Jb
Jb
Jb
Jb
Jb
Jb
Jb
Jb
Jb
Jb
Jb
Jb
Jb
Jb
Jb
Jb
Jb
Jb
Jb
Jb
bB
bB
Jb
Jb
Jb
Jb
Jb
Jb
Jb
Jb
Jb
Jb
Jb
Jb
Jb
Jb
Jb
Jb
eh
"}
(37,1,1) = {"
eh
Jb
Jb
Jb
Jb
Jb
Jb
Jb
Jb
Jb
Jb
Jb
Jb
Jb
Jb
Jb
Jb
Jb
Jb
Jb
Jb
bB
bB
Jb
Jb
Jb
Jb
Jb
Jb
Jb
Jb
Jb
Jb
Jb
Jb
Jb
Jb
Jb
Jb
eh
"}
(38,1,1) = {"
eh
Jb
Jb
Jb
Jb
Jb
Jb
Jb
Jb
Jb
Jb
Jb
Jb
Jb
Jb
Jb
Jb
Jb
Jb
Jb
Jb
bB
Jb
Jb
Jb
Jb
Jb
Jb
Jb
Jb
Jb
Jb
Jb
Jb
Jb
Jb
Jb
Jb
Jb
eh
"}
(39,1,1) = {"
eh
Jb
Jb
Jb
Jb
Jb
Jb
Jb
Jb
Jb
Jb
Jb
Jb
Jb
Jb
Jb
Jb
Jb
Jb
Jb
Jb
Jb
Jb
Jb
Jb
Jb
Jb
Jb
Jb
Jb
Jb
Jb
Jb
Jb
Jb
Jb
Jb
Jb
Jb
eh
"}
(40,1,1) = {"
eh
eh
eh
eh
eh
eh
eh
eh
eh
eh
eh
eh
eh
eh
eh
eh
eh
eh
eh
eh
eh
eh
eh
eh
eh
eh
eh
eh
eh
eh
eh
eh
eh
eh
eh
eh
eh
eh
eh
eh
"}
