//MAP CONVERTED BY dmm2tgm.py THIS HEADER COMMENT PREVENTS RECONVERSION, DO NOT REMOVE
"a" = (
/turf/simulated/mineral/vacuum,
/area/submap/outpost21/asteroid_generic)
"b" = (
/turf/template_noop,
/area/template_noop)
"g" = (
/turf/template_noop,
/area/submap/outpost21/asteroid_generic)
"k" = (
/turf/space,
/area/submap/outpost21/asteroid_generic)
"s" = (
/obj/structure/lattice,
/turf/space,
/area/submap/outpost21/asteroid_generic)
"Z" = (
/turf/simulated/mineral/floor/vacuum,
/area/submap/outpost21/asteroid_generic)

(1,1,1) = {"
b
b
b
b
b
b
b
b
b
b
b
b
b
b
b
b
b
b
b
b
b
b
b
b
b
b
b
b
b
b
b
b
b
b
b
b
b
b
b
b
b
b
b
b
b
b
b
b
b
b
b
b
b
b
b
b
b
b
b
b
"}
(2,1,1) = {"
b
g
g
g
g
g
g
g
g
g
g
g
g
g
g
g
g
g
g
g
g
g
g
g
g
g
g
g
g
g
g
g
g
g
g
g
g
g
g
g
g
g
g
g
g
g
g
g
g
g
g
g
g
g
g
g
g
g
g
b
"}
(3,1,1) = {"
b
g
g
g
g
g
g
g
g
g
g
g
g
g
g
g
g
g
g
g
g
g
g
g
g
g
g
s
g
g
g
g
g
g
g
g
g
g
g
g
s
g
g
g
g
g
g
g
g
g
g
g
g
g
g
g
g
g
g
b
"}
(4,1,1) = {"
b
g
g
g
g
g
g
g
g
g
g
g
g
g
g
g
g
g
a
a
a
a
a
a
a
a
a
s
a
a
a
a
a
a
a
a
g
g
g
s
s
g
g
g
g
g
g
g
g
g
g
g
g
g
g
g
g
g
g
b
"}
(5,1,1) = {"
b
g
g
g
g
g
g
g
g
g
g
g
g
g
g
a
a
a
a
a
a
a
a
a
a
a
a
a
a
a
a
a
a
a
a
a
a
a
a
a
a
a
a
a
g
g
g
g
g
g
g
g
g
g
g
g
g
g
g
b
"}
(6,1,1) = {"
b
g
g
g
g
g
g
g
g
g
g
g
g
a
a
a
a
a
a
a
a
a
a
a
a
a
a
a
a
a
a
a
a
a
a
a
a
a
a
a
a
a
a
a
a
a
a
g
g
g
g
g
g
g
g
g
g
g
g
b
"}
(7,1,1) = {"
b
g
g
g
g
g
g
g
g
g
g
g
a
a
a
a
a
a
a
a
a
a
a
a
a
a
a
a
a
a
a
a
a
a
a
a
a
a
a
a
a
a
a
a
a
a
a
a
g
g
g
g
g
g
g
g
g
g
g
b
"}
(8,1,1) = {"
b
g
g
g
g
g
g
g
g
g
a
a
a
a
a
a
a
a
a
a
a
a
a
a
a
a
a
a
a
a
a
a
a
a
a
a
a
a
a
a
a
a
a
a
a
a
a
a
a
a
g
g
g
g
g
g
g
g
g
b
"}
(9,1,1) = {"
b
g
g
g
g
g
g
g
g
g
a
a
a
a
a
a
a
a
a
a
a
a
a
a
a
a
a
a
a
a
a
a
a
a
a
a
a
a
a
a
a
a
a
a
a
a
a
a
a
a
a
g
g
g
g
g
g
g
g
b
"}
(10,1,1) = {"
b
g
g
g
g
g
g
g
a
a
a
a
a
a
a
a
a
Z
a
a
a
a
a
a
a
a
a
a
a
a
a
a
a
a
a
a
a
a
a
a
a
a
a
a
a
a
a
Z
Z
a
a
a
g
g
g
g
g
g
g
b
"}
(11,1,1) = {"
b
g
g
g
g
g
a
a
a
a
a
a
a
a
a
a
Z
Z
a
a
a
a
a
a
a
a
a
a
a
a
a
a
a
a
a
a
a
a
a
a
a
a
a
a
a
a
Z
Z
Z
a
a
a
a
g
g
g
g
g
g
b
"}
(12,1,1) = {"
b
g
g
g
g
g
a
a
a
a
a
a
a
a
a
a
Z
Z
a
a
a
a
a
a
a
a
a
a
a
a
a
a
a
a
a
a
a
a
a
a
a
a
a
a
a
a
Z
Z
a
a
a
a
a
g
g
g
g
g
g
b
"}
(13,1,1) = {"
b
g
g
g
g
a
a
a
a
a
a
a
a
a
a
a
a
a
a
a
a
a
a
a
a
a
a
a
a
a
a
a
a
a
a
a
a
a
a
a
a
a
a
a
a
a
a
a
a
a
a
a
a
g
g
g
g
g
g
b
"}
(14,1,1) = {"
b
g
g
g
g
a
a
a
a
a
a
a
a
a
a
a
a
a
a
a
a
a
a
a
a
a
a
a
a
a
a
a
a
a
a
a
a
a
a
a
a
a
a
a
a
a
a
a
a
a
a
a
a
a
g
g
g
g
g
b
"}
(15,1,1) = {"
b
g
g
g
g
a
a
a
a
a
a
a
a
a
a
a
a
a
a
a
a
a
a
a
a
a
a
a
a
a
a
a
a
a
a
a
a
a
a
a
a
a
a
a
a
a
a
a
a
a
a
a
a
a
g
g
g
g
g
b
"}
(16,1,1) = {"
b
g
g
g
g
a
a
a
a
a
a
a
a
a
a
a
a
a
a
a
a
a
a
a
a
a
a
a
a
a
a
a
a
a
a
a
a
a
a
a
a
a
a
a
a
a
a
a
a
a
a
a
a
a
a
g
g
g
g
b
"}
(17,1,1) = {"
b
g
g
g
a
a
a
a
a
a
a
a
a
a
a
a
a
a
a
a
a
a
a
a
a
a
a
a
a
a
a
a
a
a
a
a
a
a
a
a
a
a
a
a
a
a
a
a
a
a
a
a
a
a
a
g
g
g
g
b
"}
(18,1,1) = {"
b
g
g
g
a
a
a
a
a
a
a
a
a
a
a
a
a
a
a
a
a
a
a
a
a
a
a
a
a
a
a
a
a
a
a
a
a
a
a
a
a
a
a
a
a
a
a
a
a
a
a
a
a
a
a
g
g
g
g
b
"}
(19,1,1) = {"
b
g
g
g
a
a
a
a
a
a
a
a
a
a
a
a
a
a
a
a
a
a
a
a
a
a
a
a
a
a
a
a
a
a
a
a
a
a
a
a
a
a
a
a
a
a
a
a
a
a
a
a
a
a
a
a
g
g
g
b
"}
(20,1,1) = {"
b
g
g
g
a
a
a
a
a
a
a
a
a
a
a
a
a
a
a
a
a
a
a
a
a
a
a
a
a
a
a
a
a
a
a
a
a
a
a
a
a
a
a
a
a
a
a
a
a
a
a
a
a
a
a
a
s
s
g
b
"}
(21,1,1) = {"
b
g
g
g
a
a
a
a
a
Z
Z
Z
a
a
a
a
a
a
a
a
a
a
a
a
a
a
a
a
a
a
a
a
a
a
a
a
a
a
a
a
a
a
a
a
a
a
a
a
a
a
a
a
a
a
a
a
s
g
g
b
"}
(22,1,1) = {"
b
g
g
g
a
a
a
a
a
a
Z
Z
Z
a
a
a
a
a
a
a
a
a
a
a
a
a
a
a
a
a
a
a
a
a
a
a
a
a
a
a
a
a
a
a
a
a
a
Z
Z
a
a
a
a
a
a
a
g
g
g
b
"}
(23,1,1) = {"
b
g
s
s
s
a
a
a
a
a
a
a
a
a
a
a
a
a
a
a
a
a
a
a
a
a
Z
Z
Z
Z
Z
a
a
a
a
a
a
a
a
a
a
a
a
a
a
a
a
Z
Z
Z
a
a
a
a
a
a
g
g
g
b
"}
(24,1,1) = {"
b
g
g
g
g
a
a
a
a
a
a
a
a
a
a
a
a
a
a
a
a
a
a
a
a
Z
Z
Z
Z
Z
Z
Z
Z
Z
a
a
a
a
a
a
a
a
a
a
a
a
a
a
Z
Z
Z
a
a
a
a
a
g
g
g
b
"}
(25,1,1) = {"
b
g
g
g
g
a
a
a
a
a
a
a
a
a
a
a
a
a
a
a
a
a
a
a
a
Z
Z
k
k
k
k
k
k
Z
a
a
a
a
a
a
a
a
a
a
a
a
a
a
a
Z
Z
a
a
a
a
g
g
g
g
b
"}
(26,1,1) = {"
b
g
g
g
g
a
a
a
a
a
a
a
a
a
a
a
a
a
a
a
a
a
a
a
Z
k
k
k
k
k
k
k
k
Z
Z
Z
a
a
a
a
a
a
a
a
a
a
a
a
a
Z
Z
a
a
a
a
g
g
g
g
b
"}
(27,1,1) = {"
b
g
g
g
g
g
a
a
a
a
a
a
a
a
a
a
a
a
a
a
a
a
a
Z
Z
k
k
k
k
k
k
k
k
k
Z
Z
a
a
a
a
a
a
a
a
a
a
a
a
a
a
a
a
a
a
a
a
g
g
g
b
"}
(28,1,1) = {"
b
g
g
g
g
g
a
a
a
a
a
a
a
a
a
a
a
a
a
a
a
a
Z
Z
Z
k
k
k
k
k
k
k
k
k
Z
Z
Z
a
a
a
a
a
a
a
a
a
a
a
a
a
a
a
a
a
a
a
g
g
g
b
"}
(29,1,1) = {"
b
g
g
g
g
g
a
a
a
a
a
a
a
a
a
a
a
a
a
a
a
a
Z
Z
Z
k
k
k
k
k
k
k
k
k
k
Z
Z
a
a
a
a
a
a
a
a
a
a
a
a
a
a
a
a
a
a
a
a
g
g
b
"}
(30,1,1) = {"
b
g
g
g
g
g
a
a
a
a
a
a
a
a
a
a
a
a
a
a
a
a
Z
Z
Z
k
k
k
k
k
k
k
k
k
k
Z
Z
Z
a
a
a
a
a
a
a
a
a
a
a
a
a
a
a
a
a
a
a
g
g
b
"}
(31,1,1) = {"
b
g
g
g
g
a
a
a
a
a
a
a
a
a
a
a
a
a
a
a
a
a
Z
Z
k
k
k
k
k
k
k
k
k
k
k
Z
Z
Z
a
a
a
a
a
a
a
a
a
a
a
a
a
a
a
a
a
a
a
g
g
b
"}
(32,1,1) = {"
b
g
g
g
a
a
a
a
a
a
a
a
a
a
a
a
a
a
a
a
a
a
Z
k
k
k
k
k
k
k
k
k
k
k
k
Z
Z
a
a
a
a
a
a
a
a
a
a
a
a
a
a
a
a
a
a
a
a
g
g
b
"}
(33,1,1) = {"
b
g
g
g
a
a
a
a
a
a
a
a
a
a
a
a
a
a
a
a
a
a
Z
k
k
k
k
k
k
k
k
k
k
k
k
Z
Z
a
a
a
a
a
a
a
a
a
a
a
a
a
a
a
a
a
a
a
a
g
g
b
"}
(34,1,1) = {"
b
g
g
g
a
a
a
a
a
a
a
a
a
a
a
a
a
a
a
a
a
a
Z
k
k
k
k
k
k
k
k
k
k
k
k
Z
a
a
a
a
a
a
a
a
a
a
a
a
a
a
a
a
a
a
a
a
a
g
g
b
"}
(35,1,1) = {"
b
g
g
g
a
a
a
a
a
a
a
a
a
a
a
a
a
a
a
a
a
a
Z
k
k
k
k
k
k
k
k
k
k
k
Z
Z
a
a
a
a
a
a
a
a
a
a
a
a
a
a
a
a
a
a
a
a
a
g
g
b
"}
(36,1,1) = {"
b
g
g
g
a
a
a
a
a
a
a
a
a
a
a
a
a
a
a
a
a
a
Z
Z
k
k
k
k
k
k
k
k
k
k
Z
Z
a
a
a
a
a
a
a
a
a
a
a
a
a
a
a
a
a
a
a
a
g
g
g
b
"}
(37,1,1) = {"
b
g
g
a
a
a
a
a
a
a
a
a
a
a
a
a
a
a
a
a
a
a
Z
Z
k
k
k
k
k
k
k
k
k
Z
Z
Z
a
a
a
a
a
a
a
a
a
a
a
a
a
a
a
a
a
a
a
a
g
g
g
b
"}
(38,1,1) = {"
b
g
g
a
a
a
a
a
a
a
a
a
a
a
a
a
a
a
a
a
a
a
a
Z
Z
Z
k
k
k
k
k
k
Z
Z
Z
Z
a
a
a
a
a
a
a
a
a
a
a
a
a
a
a
a
a
a
a
a
g
g
g
b
"}
(39,1,1) = {"
b
g
g
a
a
a
a
a
a
a
a
a
a
a
a
a
a
a
a
a
a
a
a
Z
Z
Z
Z
Z
Z
Z
Z
Z
Z
Z
Z
a
a
a
a
a
a
a
a
a
a
a
a
a
a
a
a
a
a
a
a
g
g
g
g
b
"}
(40,1,1) = {"
b
g
g
a
a
a
a
a
a
a
a
a
a
a
a
a
a
Z
a
a
a
a
a
a
a
a
Z
Z
Z
Z
Z
Z
Z
Z
a
a
a
a
a
a
a
a
a
a
a
a
a
a
a
a
a
a
a
a
a
a
g
g
g
b
"}
(41,1,1) = {"
b
g
g
a
a
a
a
a
a
a
a
a
a
a
a
a
Z
Z
a
a
a
a
a
a
a
a
a
a
a
a
a
a
a
a
a
a
a
a
a
a
a
a
a
a
a
a
a
a
a
a
a
a
a
a
a
a
g
g
g
b
"}
(42,1,1) = {"
b
g
g
a
a
a
a
a
a
a
a
a
a
a
a
a
Z
Z
a
a
a
a
a
a
a
a
a
a
a
a
a
a
a
a
a
a
a
a
a
a
a
a
a
a
a
a
a
a
a
a
a
a
a
a
a
a
g
g
g
b
"}
(43,1,1) = {"
b
g
g
g
a
a
a
a
a
a
a
a
a
a
a
a
a
a
a
a
a
a
a
a
a
a
a
a
a
a
a
a
a
a
a
a
a
a
a
a
a
a
a
a
a
a
a
a
a
a
a
a
a
a
a
g
g
g
g
b
"}
(44,1,1) = {"
b
g
g
g
a
a
a
a
a
a
a
a
a
a
a
a
a
a
a
a
a
a
a
a
a
a
a
a
a
a
a
a
a
a
a
a
a
a
a
a
a
a
a
a
a
a
a
a
a
a
a
a
a
a
a
g
g
g
g
b
"}
(45,1,1) = {"
b
g
g
g
a
a
a
a
a
a
a
a
a
a
a
a
a
a
a
a
a
a
a
a
a
a
a
a
a
a
a
a
a
a
a
a
a
a
a
a
a
a
a
a
a
a
a
a
a
a
a
a
a
a
g
g
g
g
g
b
"}
(46,1,1) = {"
b
g
g
g
g
a
a
a
a
a
a
a
a
a
a
a
a
a
a
a
a
a
a
a
a
a
a
a
a
a
a
a
a
a
a
a
a
a
a
a
a
a
a
a
a
a
a
a
a
a
a
a
a
a
g
g
g
g
g
b
"}
(47,1,1) = {"
b
g
g
g
g
a
a
a
a
a
a
a
a
a
a
a
a
a
a
a
a
a
a
a
a
a
a
a
a
a
a
a
a
a
a
a
a
a
a
a
a
a
a
a
a
a
a
a
a
a
a
a
a
a
g
g
g
g
g
b
"}
(48,1,1) = {"
b
g
g
g
g
a
a
a
a
a
a
a
a
a
a
a
a
a
a
a
a
a
a
a
a
a
a
a
a
a
a
a
a
a
a
a
a
a
a
a
a
a
a
a
a
a
a
a
a
a
a
a
a
a
g
g
g
g
g
b
"}
(49,1,1) = {"
b
g
g
g
g
a
a
a
a
a
a
a
a
a
a
a
a
a
a
a
a
a
a
a
a
a
a
a
a
a
a
a
a
a
a
a
a
a
a
a
a
a
a
a
a
a
a
a
a
a
a
a
a
a
g
g
g
g
g
b
"}
(50,1,1) = {"
b
g
g
s
s
s
a
a
a
a
a
a
a
a
a
a
a
a
a
a
a
a
a
a
a
a
a
a
a
a
a
a
a
a
a
a
a
a
a
a
a
a
a
a
a
a
a
a
a
a
a
a
a
g
g
g
g
g
g
b
"}
(51,1,1) = {"
b
g
g
g
g
s
a
a
a
a
a
a
a
a
a
a
a
a
a
a
a
a
a
a
a
a
a
a
a
a
a
a
a
a
a
a
a
a
a
a
a
a
a
a
a
a
a
a
a
a
a
a
g
g
g
g
g
g
g
b
"}
(52,1,1) = {"
b
g
g
g
g
g
g
a
a
a
a
a
a
a
a
a
a
a
a
a
a
a
a
a
a
a
a
a
a
a
a
a
a
a
a
a
a
a
a
a
a
a
a
a
a
a
a
a
a
a
a
a
g
g
g
g
g
g
g
b
"}
(53,1,1) = {"
b
g
g
g
g
g
g
a
a
a
a
a
a
a
a
a
a
a
a
a
a
a
a
a
a
a
a
a
a
a
a
a
a
a
a
a
a
a
a
a
a
a
a
a
a
a
a
a
a
a
a
g
g
g
g
g
g
g
g
b
"}
(54,1,1) = {"
b
g
g
g
g
g
g
g
a
a
a
a
a
a
a
a
a
a
a
a
a
a
a
a
a
a
a
a
a
a
a
a
a
a
a
a
a
a
a
a
a
a
a
s
a
a
a
a
a
g
g
g
g
g
g
g
g
g
g
b
"}
(55,1,1) = {"
b
g
g
g
g
g
g
g
g
g
g
a
a
a
a
a
a
a
a
a
a
a
a
a
a
a
a
a
a
a
a
a
a
a
a
a
a
a
a
a
a
a
a
g
g
g
g
g
g
g
g
g
g
g
g
g
g
g
g
b
"}
(56,1,1) = {"
b
g
g
g
g
g
g
g
g
g
g
g
s
s
g
a
a
a
a
a
a
a
a
a
a
a
a
a
a
a
a
a
a
a
a
a
a
g
g
g
s
s
g
g
g
g
g
g
g
g
g
g
g
g
g
g
g
g
g
b
"}
(57,1,1) = {"
b
g
g
g
g
g
g
g
g
g
g
g
g
s
g
g
g
g
g
g
a
a
a
a
a
a
a
a
a
a
a
a
a
a
g
g
g
g
g
g
g
s
g
g
g
g
g
g
g
g
g
g
g
g
g
g
g
g
g
b
"}
(58,1,1) = {"
b
g
g
g
g
g
g
g
g
g
g
g
g
g
g
g
g
g
g
g
g
g
g
g
g
g
g
g
g
g
g
g
g
g
g
g
g
g
g
g
g
s
g
g
g
g
g
g
g
g
g
g
g
g
g
g
g
g
g
b
"}
(59,1,1) = {"
b
g
g
g
g
g
g
g
g
g
g
g
g
g
g
g
g
g
g
g
g
g
g
g
g
g
g
g
g
g
g
g
g
g
g
g
g
g
g
g
g
g
g
g
g
g
g
g
g
g
g
g
g
g
g
g
g
g
g
b
"}
(60,1,1) = {"
b
b
b
b
b
b
b
b
b
b
b
b
b
b
b
b
b
b
b
b
b
b
b
b
b
b
b
b
b
b
b
b
b
b
b
b
b
b
b
b
b
b
b
b
b
b
b
b
b
b
b
b
b
b
b
b
b
b
b
b
"}
