//MAP CONVERTED BY dmm2tgm.py THIS HEADER COMMENT PREVENTS RECONVERSION, DO NOT REMOVE
"a" = (
/turf/simulated/mineral/vacuum,
/area/submap/outpost21/asteroid_generic)
"j" = (
/turf/template_noop,
/area/submap/outpost21/asteroid_generic)
"r" = (
/turf/simulated/mineral/floor/vacuum,
/area/submap/outpost21/asteroid_generic)
"K" = (
/turf/template_noop,
/area/template_noop)
"T" = (
/obj/structure/lattice,
/turf/space,
/area/submap/outpost21/asteroid_generic)
"Z" = (
/turf/space,
/area/submap/outpost21/asteroid_generic)

(1,1,1) = {"
K
K
K
K
K
K
K
K
K
K
K
K
K
K
K
K
K
K
K
K
K
K
K
K
K
K
K
K
K
K
"}
(2,1,1) = {"
K
j
j
j
j
j
j
j
j
j
j
j
j
j
j
j
j
j
j
j
j
j
j
j
j
j
j
j
j
K
"}
(3,1,1) = {"
K
j
j
j
j
j
j
j
j
j
j
j
j
j
j
j
j
j
j
j
j
Z
j
j
j
j
j
j
j
K
"}
(4,1,1) = {"
K
j
j
j
j
j
j
j
j
j
j
j
j
j
j
j
j
j
j
j
j
Z
Z
j
j
j
j
j
j
K
"}
(5,1,1) = {"
K
j
j
j
j
j
j
j
j
j
j
j
j
j
j
a
a
a
a
a
j
Z
T
j
j
j
j
j
j
K
"}
(6,1,1) = {"
K
j
j
j
j
j
j
j
j
j
j
j
Z
a
a
a
a
a
a
a
a
a
T
Z
j
j
j
j
j
K
"}
(7,1,1) = {"
K
j
j
j
j
j
j
j
Z
T
T
a
a
a
a
a
a
a
a
a
a
a
a
a
j
j
j
j
j
K
"}
(8,1,1) = {"
K
j
j
j
j
j
Z
Z
a
a
a
a
a
a
a
a
a
a
a
a
a
a
a
a
j
j
j
j
j
K
"}
(9,1,1) = {"
K
j
j
j
j
j
Z
a
a
a
a
a
a
a
a
a
a
a
a
a
a
a
a
a
a
j
j
j
j
K
"}
(10,1,1) = {"
K
j
j
j
j
j
j
a
a
a
a
a
a
a
a
a
a
r
r
a
a
a
a
a
a
a
j
j
j
K
"}
(11,1,1) = {"
K
j
j
j
j
a
a
a
a
a
a
a
a
a
a
a
r
r
r
a
a
a
a
a
a
a
j
j
j
K
"}
(12,1,1) = {"
K
j
Z
T
T
a
a
a
a
a
a
a
a
a
a
a
r
r
a
a
a
a
a
a
a
a
j
j
j
K
"}
(13,1,1) = {"
K
j
j
Z
a
a
a
a
a
a
a
a
a
a
a
a
a
a
a
a
a
a
a
a
a
a
j
j
j
K
"}
(14,1,1) = {"
K
j
j
Z
a
a
a
a
a
a
a
a
a
a
a
a
a
a
a
a
a
a
a
a
a
a
j
j
j
K
"}
(15,1,1) = {"
K
j
j
Z
a
a
a
a
a
a
a
a
a
a
a
a
a
a
a
a
a
a
a
a
a
a
T
T
j
K
"}
(16,1,1) = {"
K
j
j
j
a
a
a
a
a
a
a
a
a
a
a
a
a
a
a
a
a
a
a
a
a
a
a
j
j
K
"}
(17,1,1) = {"
K
j
j
j
a
a
a
a
a
a
a
a
a
a
a
a
a
a
a
a
a
a
a
a
a
a
a
j
j
K
"}
(18,1,1) = {"
K
j
j
j
a
a
a
a
a
a
a
a
a
a
a
a
a
a
a
a
a
a
a
a
a
a
a
j
j
K
"}
(19,1,1) = {"
K
j
j
j
a
a
a
a
a
a
a
a
a
a
a
a
a
a
a
a
a
a
a
a
a
a
a
j
j
K
"}
(20,1,1) = {"
K
j
j
j
a
a
a
a
a
a
a
a
a
a
a
a
a
a
a
a
a
a
a
a
a
a
a
j
j
K
"}
(21,1,1) = {"
K
j
j
j
a
a
a
a
a
r
r
r
a
a
a
a
a
a
a
a
a
a
a
a
a
a
a
j
j
K
"}
(22,1,1) = {"
K
j
j
j
a
a
a
a
a
a
r
r
r
a
a
a
a
a
a
a
a
a
a
a
a
a
a
j
j
K
"}
(23,1,1) = {"
K
j
j
j
j
T
a
a
a
a
a
a
a
a
a
a
a
a
a
a
a
a
a
a
a
a
j
j
j
K
"}
(24,1,1) = {"
K
j
j
j
j
T
a
a
a
a
a
a
j
T
a
a
a
a
a
a
a
a
a
a
a
a
j
j
j
K
"}
(25,1,1) = {"
K
j
j
j
j
Z
T
T
j
j
j
j
j
T
T
a
a
a
a
a
a
a
a
a
a
a
j
j
j
K
"}
(26,1,1) = {"
K
j
j
j
j
j
T
j
j
j
j
j
j
T
j
j
a
a
a
a
a
a
a
a
a
j
j
j
j
K
"}
(27,1,1) = {"
K
j
j
j
j
j
T
j
j
j
j
j
j
T
j
j
j
j
j
j
j
T
T
j
j
j
j
j
j
K
"}
(28,1,1) = {"
K
j
j
j
j
j
j
j
j
j
j
j
j
j
j
j
j
j
j
j
j
T
j
j
j
j
j
j
j
K
"}
(29,1,1) = {"
K
j
j
j
j
j
j
j
j
j
j
j
j
j
j
j
j
j
j
j
j
j
j
j
j
j
j
j
j
K
"}
(30,1,1) = {"
K
K
K
K
K
K
K
K
K
K
K
K
K
K
K
K
K
K
K
K
K
K
K
K
K
K
K
K
K
K
"}
