//MAP CONVERTED BY dmm2tgm.py THIS HEADER COMMENT PREVENTS RECONVERSION, DO NOT REMOVE
"a" = (
/turf/template_noop,
/area/template_noop)
"b" = (
/turf/template_noop,
/area/submap/outpost21/asteroid_generic)
"c" = (
/obj/structure/lattice,
/turf/space,
/area/submap/outpost21/asteroid_generic)
"d" = (
/turf/simulated/mineral/vacuum,
/area/submap/outpost21/asteroid_generic)
"e" = (
/turf/simulated/mineral/floor/vacuum,
/area/submap/outpost21/asteroid_generic)
"L" = (
/turf/space,
/area/submap/outpost21/asteroid_generic)

(1,1,1) = {"
a
a
a
a
a
a
a
a
a
a
a
a
a
a
a
a
a
a
a
a
a
a
a
a
a
a
a
a
a
a
a
a
a
a
a
a
a
a
a
a
a
a
a
a
a
a
a
a
a
a
a
a
a
a
a
a
a
a
a
a
a
a
a
a
a
a
a
a
a
a
a
a
a
a
a
a
a
a
a
a
"}
(2,1,1) = {"
a
b
b
b
b
b
b
b
b
b
b
b
b
b
b
b
b
b
b
b
b
b
b
b
b
b
b
b
b
b
b
b
b
b
b
b
b
b
b
b
b
b
b
b
b
b
b
b
b
b
b
b
b
b
b
b
b
b
b
b
b
b
b
b
b
b
b
b
b
b
b
b
b
b
b
b
b
b
b
a
"}
(3,1,1) = {"
a
b
b
b
b
b
b
b
b
b
b
b
b
b
b
b
b
c
c
L
b
b
b
b
c
b
b
b
b
b
b
b
c
b
b
b
b
b
b
b
b
b
b
b
b
b
b
b
b
b
b
b
b
b
b
b
b
b
b
b
b
b
b
b
b
b
b
b
b
b
b
b
b
b
b
b
b
b
b
a
"}
(4,1,1) = {"
a
b
b
b
b
b
b
b
b
b
b
b
b
b
b
b
c
L
c
L
L
b
b
b
c
L
L
L
L
L
b
b
c
b
b
b
b
b
b
b
b
b
b
b
b
b
b
b
b
b
b
b
b
b
b
b
b
b
b
b
b
b
b
b
b
b
b
b
b
b
b
b
b
b
b
b
b
b
b
a
"}
(5,1,1) = {"
a
b
b
b
b
b
b
b
b
b
b
b
b
c
c
d
c
c
c
d
d
d
d
d
c
c
c
d
d
d
d
L
c
b
b
c
b
b
b
b
b
b
b
b
b
b
b
b
b
b
b
b
b
b
b
b
b
c
b
b
b
b
b
b
b
b
b
b
b
b
b
b
b
b
b
b
b
b
b
a
"}
(6,1,1) = {"
a
b
b
b
b
b
b
b
c
b
b
d
d
d
d
d
d
d
d
d
d
d
d
d
d
d
d
d
d
d
d
d
c
L
b
c
b
b
b
b
b
b
b
b
b
b
b
b
b
b
b
b
b
b
b
b
c
c
b
b
b
b
c
b
b
b
b
b
b
b
b
b
b
b
b
b
b
b
b
a
"}
(7,1,1) = {"
a
b
b
b
b
b
b
b
c
d
d
d
d
d
d
d
d
d
d
d
d
d
d
d
d
d
d
d
d
d
d
d
d
c
c
c
c
c
b
b
b
b
b
b
b
b
b
b
b
b
b
b
b
b
b
b
c
c
b
b
b
b
c
b
b
b
b
b
b
b
b
b
b
b
b
b
b
b
b
a
"}
(8,1,1) = {"
a
b
b
b
b
b
b
c
c
c
d
d
d
d
d
d
d
d
d
d
d
d
d
d
d
d
d
d
d
d
d
d
d
d
d
c
b
b
b
b
b
b
b
b
b
b
b
b
b
b
b
b
b
b
c
c
c
c
c
c
c
c
c
b
b
b
b
b
b
b
b
b
b
b
b
b
b
b
b
a
"}
(9,1,1) = {"
a
b
b
b
b
b
b
b
b
L
c
d
d
d
d
d
d
d
d
d
d
d
d
d
d
d
d
d
d
d
d
d
d
d
d
d
L
b
b
b
b
b
c
b
b
b
b
c
b
b
b
b
b
b
b
b
c
c
L
L
L
L
c
b
b
b
b
b
c
b
b
b
b
b
b
b
b
b
b
a
"}
(10,1,1) = {"
a
b
b
b
b
b
b
b
L
L
c
L
d
d
d
d
d
d
d
d
d
d
d
d
d
d
d
d
d
d
d
d
d
d
d
d
d
c
c
c
c
c
c
c
c
c
c
c
c
b
b
b
b
b
b
b
c
c
L
L
L
L
c
b
b
b
b
b
c
b
b
b
b
b
b
b
b
b
b
a
"}
(11,1,1) = {"
a
b
b
b
b
b
b
L
d
d
c
d
d
d
d
d
d
d
d
d
d
d
d
d
d
d
d
d
d
d
d
d
d
d
d
d
d
d
d
d
L
L
c
L
L
L
L
L
c
b
b
b
b
b
b
b
c
c
L
L
d
d
d
d
L
b
c
b
c
b
b
b
b
b
b
b
b
b
b
a
"}
(12,1,1) = {"
a
b
b
b
c
c
c
d
d
d
d
d
d
d
d
d
d
d
d
d
d
d
d
d
d
d
d
d
d
d
d
d
d
d
d
d
d
d
d
d
d
L
c
L
L
L
L
L
c
b
b
b
b
b
L
L
c
c
d
d
d
d
d
d
d
L
c
c
c
c
c
b
b
b
b
b
b
b
b
a
"}
(13,1,1) = {"
a
b
b
b
L
d
d
d
d
d
d
d
d
d
d
d
d
d
d
d
d
d
d
d
d
d
d
d
d
d
d
d
d
d
d
d
d
d
d
d
d
L
c
L
L
L
L
L
c
c
c
c
c
c
c
c
c
d
d
d
d
d
d
d
d
d
d
d
c
b
b
b
b
b
b
b
b
b
b
a
"}
(14,1,1) = {"
a
b
b
b
d
d
d
d
d
d
d
d
d
d
d
d
d
d
d
d
d
d
d
d
d
d
d
d
d
d
d
d
d
d
d
d
d
d
d
d
d
L
c
c
c
c
c
L
c
L
L
L
L
L
L
d
d
d
d
d
d
d
d
d
d
d
d
d
d
L
b
b
b
b
b
b
b
b
b
a
"}
(15,1,1) = {"
a
b
b
L
d
d
d
d
d
d
d
d
d
d
d
d
d
d
d
d
d
d
d
d
d
d
d
d
d
d
d
d
d
d
d
d
d
d
d
d
d
d
c
d
L
L
L
L
c
L
L
L
L
L
L
d
d
d
d
d
d
d
d
d
d
d
d
d
d
L
b
b
b
b
b
b
b
b
b
a
"}
(16,1,1) = {"
a
b
b
d
d
d
d
d
d
d
d
d
d
d
d
d
d
d
d
d
d
d
d
d
d
d
d
d
d
d
d
d
d
d
d
d
d
d
d
d
d
d
d
d
d
d
L
L
c
c
c
d
d
d
d
d
d
d
d
d
d
d
d
d
d
d
d
d
d
L
L
b
b
b
b
b
b
b
b
a
"}
(17,1,1) = {"
a
b
b
d
d
d
d
d
d
d
d
d
d
d
d
d
d
d
d
d
d
d
e
e
e
d
d
d
d
d
d
d
d
d
d
d
d
d
d
d
d
d
d
d
d
d
L
L
c
L
L
d
d
d
d
d
d
d
d
d
d
d
d
d
d
d
d
d
d
d
L
c
b
b
b
b
b
b
b
a
"}
(18,1,1) = {"
a
b
b
c
d
d
d
d
d
d
d
d
d
d
d
d
d
d
d
d
d
e
e
e
e
e
d
d
d
d
d
d
d
d
d
d
d
d
d
d
d
d
d
d
d
d
L
L
c
L
L
d
d
d
d
d
d
d
d
d
d
d
d
d
d
d
d
d
d
d
c
c
c
c
c
c
b
b
b
a
"}
(19,1,1) = {"
a
b
b
c
d
d
d
d
d
d
d
d
d
d
d
d
d
d
d
d
e
e
L
L
e
e
d
d
d
d
d
d
d
d
d
d
d
d
d
d
d
d
d
d
d
d
d
c
c
c
d
d
d
d
d
d
d
d
d
d
d
d
d
d
d
d
d
d
d
d
d
c
b
b
b
b
b
b
b
a
"}
(20,1,1) = {"
a
b
c
c
c
d
d
d
d
d
d
d
d
d
d
d
d
d
d
d
e
L
L
L
e
d
d
d
d
d
d
d
d
d
d
d
d
d
d
d
d
d
d
d
d
d
d
d
d
d
d
d
d
d
d
d
d
d
d
d
d
d
d
d
d
d
d
d
d
d
d
c
b
b
b
b
b
b
b
a
"}
(21,1,1) = {"
a
b
b
c
d
d
d
d
d
d
d
d
d
d
d
d
d
d
d
e
e
L
L
e
e
d
d
d
d
d
d
d
d
d
d
d
d
d
d
d
d
d
d
d
d
d
d
d
d
d
d
d
d
d
d
d
d
d
d
d
d
d
d
d
d
d
d
d
d
d
d
c
b
b
b
b
b
b
b
a
"}
(22,1,1) = {"
a
b
b
d
d
d
d
d
d
d
d
d
d
d
d
d
d
d
d
e
L
L
L
e
d
d
d
d
d
d
d
d
d
d
d
d
d
d
d
d
d
d
d
d
d
d
d
d
d
d
d
d
d
d
d
d
d
d
d
d
d
d
d
d
d
d
d
d
d
d
d
c
b
b
b
b
b
b
b
a
"}
(23,1,1) = {"
a
b
b
b
d
d
d
d
d
d
d
d
d
d
d
d
d
d
e
e
L
L
e
e
d
d
d
d
d
d
d
d
d
d
d
d
d
d
d
d
d
d
d
d
d
d
d
d
d
d
d
d
d
d
d
d
d
d
d
d
d
d
d
d
d
d
d
d
d
d
d
L
b
b
b
b
b
b
b
a
"}
(24,1,1) = {"
a
b
b
c
d
d
d
d
d
d
d
d
d
d
d
d
d
e
e
e
L
L
e
e
d
d
d
d
d
d
d
d
d
d
d
d
d
d
d
d
d
d
d
d
d
d
d
d
d
d
d
d
d
d
d
d
d
d
d
d
d
d
d
d
d
d
d
d
d
d
d
L
b
b
b
b
b
b
b
a
"}
(25,1,1) = {"
a
b
b
c
d
d
d
d
d
d
d
d
d
d
d
d
d
d
e
e
L
L
e
e
d
d
d
d
d
d
d
d
d
d
d
d
d
d
d
d
d
d
d
d
d
d
d
d
d
d
d
d
d
d
d
d
d
d
d
d
d
d
d
d
d
d
d
d
d
d
d
L
b
b
b
b
b
b
b
a
"}
(26,1,1) = {"
a
b
b
c
d
d
d
d
d
d
d
d
d
d
d
d
d
d
e
e
L
L
e
e
d
d
d
d
d
d
d
d
d
d
d
d
d
d
d
d
d
d
d
d
d
d
d
d
d
d
d
d
d
d
d
d
d
d
d
d
d
d
d
d
d
d
d
d
d
d
d
c
c
c
b
b
b
b
b
a
"}
(27,1,1) = {"
a
b
b
L
d
d
d
d
d
d
d
d
d
d
d
d
d
d
d
e
e
e
e
d
d
d
d
d
d
d
d
d
d
d
d
d
d
d
d
d
d
d
d
d
d
d
d
d
d
d
d
d
d
d
d
d
d
d
d
d
d
d
d
d
d
d
d
d
d
d
d
c
L
b
b
b
b
b
b
a
"}
(28,1,1) = {"
a
b
b
b
d
d
d
d
d
d
d
d
d
d
d
d
d
d
d
e
e
e
e
d
d
d
d
d
d
d
d
d
d
d
d
d
d
d
d
d
d
d
d
d
d
d
d
d
d
d
d
d
d
d
d
d
d
d
d
d
d
d
d
d
d
d
d
d
d
d
d
c
L
b
b
b
b
b
b
a
"}
(29,1,1) = {"
a
b
b
b
c
d
d
d
d
d
d
d
d
d
d
d
d
d
d
d
e
e
d
d
d
d
d
d
d
d
d
d
d
d
d
d
d
d
d
d
d
d
d
d
d
d
d
d
d
d
d
d
d
d
d
d
d
d
d
d
d
d
d
d
d
d
d
d
d
d
c
c
c
c
c
b
b
b
b
a
"}
(30,1,1) = {"
a
b
b
b
c
d
d
d
d
d
d
d
d
d
d
d
d
d
d
d
d
d
d
d
d
d
d
d
d
d
d
d
d
d
d
d
d
d
d
d
d
d
d
d
d
d
d
d
d
d
d
d
d
d
d
d
d
d
d
d
d
d
d
d
d
d
d
d
d
d
d
c
L
b
b
b
b
b
b
a
"}
(31,1,1) = {"
a
b
b
b
c
d
d
d
d
d
d
d
d
d
d
d
d
d
d
d
d
d
d
d
d
d
d
d
d
d
d
d
d
d
d
d
d
d
d
d
d
d
d
d
d
d
d
d
d
d
d
d
d
d
d
d
d
d
d
d
d
d
d
d
d
d
d
d
d
d
d
c
L
b
b
b
b
b
b
a
"}
(32,1,1) = {"
a
b
b
b
c
d
d
d
d
d
d
d
d
d
d
d
d
d
d
d
d
d
d
d
d
d
d
d
d
d
d
d
d
d
d
d
d
d
d
d
d
d
d
d
d
d
d
d
d
d
d
d
d
d
d
d
d
d
d
d
d
d
d
d
d
d
d
d
d
d
d
d
L
b
b
b
b
b
b
a
"}
(33,1,1) = {"
a
b
c
c
c
c
d
d
d
d
d
d
d
d
d
d
d
d
d
d
d
d
d
d
d
d
d
d
d
d
d
d
d
d
d
d
d
d
d
d
d
d
d
d
d
d
d
d
d
d
d
d
d
d
d
d
d
d
d
d
d
d
d
d
d
d
d
d
d
d
d
d
L
b
b
b
b
b
b
a
"}
(34,1,1) = {"
a
b
b
b
c
d
d
d
d
d
d
d
d
d
d
d
d
d
d
d
d
d
d
d
d
d
d
d
d
d
d
d
d
d
d
d
d
d
d
d
d
d
d
d
d
d
d
d
d
d
d
d
d
d
d
d
d
d
d
d
d
d
d
d
d
d
d
d
d
d
d
d
L
b
b
b
b
b
b
a
"}
(35,1,1) = {"
a
b
b
b
d
d
d
d
d
d
d
d
d
d
d
d
d
d
d
d
d
d
d
d
d
d
d
d
d
d
d
d
d
d
d
d
d
d
d
d
d
d
d
d
d
d
d
d
d
d
d
d
d
d
d
d
d
d
d
d
d
d
d
d
d
d
d
d
d
d
d
d
c
b
b
b
b
b
b
a
"}
(36,1,1) = {"
a
b
b
b
d
d
d
d
d
d
d
d
d
d
d
d
d
d
d
d
d
d
d
d
d
d
d
d
d
d
d
d
d
d
d
d
e
e
d
d
d
d
d
d
d
d
d
d
d
d
d
d
d
d
d
d
d
d
d
d
d
d
d
d
d
d
d
d
d
d
d
d
c
b
b
b
b
b
b
a
"}
(37,1,1) = {"
a
b
b
b
d
d
d
d
d
d
d
d
d
d
d
d
d
d
d
d
d
d
d
d
d
d
d
d
d
d
d
d
d
d
d
d
e
e
e
e
e
d
d
d
d
d
d
d
d
d
d
d
d
d
d
d
d
d
d
d
d
d
d
d
d
d
d
d
d
d
d
d
c
c
c
c
b
b
b
a
"}
(38,1,1) = {"
a
b
b
b
d
d
d
d
d
d
d
d
d
d
d
d
d
d
d
d
d
d
d
d
d
d
d
d
d
d
d
d
d
d
d
d
d
e
e
e
e
d
d
d
d
d
d
d
d
d
d
d
d
d
d
d
d
d
d
d
d
d
d
d
d
d
d
d
d
d
d
d
L
c
b
b
b
b
b
a
"}
(39,1,1) = {"
a
b
b
b
b
d
d
d
d
d
d
d
d
d
d
d
d
d
d
d
d
d
d
d
d
d
d
d
d
d
d
d
d
d
d
d
d
e
e
L
L
e
e
e
e
d
d
d
d
d
d
d
d
d
d
d
d
d
d
d
d
d
d
d
d
d
d
d
d
d
d
d
d
c
b
b
b
b
b
a
"}
(40,1,1) = {"
a
b
b
b
b
d
d
d
d
d
d
d
d
d
d
d
d
d
d
d
d
d
d
d
d
d
d
d
d
d
d
d
d
d
d
d
d
e
e
L
L
L
e
e
e
d
d
d
d
d
d
d
d
d
d
d
d
d
d
d
d
d
d
d
d
d
d
d
d
d
d
d
d
c
b
b
b
b
b
a
"}
(41,1,1) = {"
a
b
b
b
b
d
d
d
d
d
d
d
d
d
d
d
d
d
d
d
d
d
d
d
d
d
d
d
d
d
d
d
d
d
d
d
d
e
e
L
L
L
L
e
e
e
e
e
d
d
d
d
d
d
d
d
d
d
d
d
d
d
d
d
d
d
d
d
d
d
d
d
d
c
b
b
b
b
b
a
"}
(42,1,1) = {"
a
b
b
b
b
b
c
d
d
d
d
d
d
d
d
d
d
d
d
d
d
d
d
d
d
d
d
d
d
d
d
d
d
d
d
d
d
d
e
e
L
e
L
e
e
e
e
e
d
d
d
d
d
d
d
d
d
d
d
d
d
d
d
d
d
d
d
d
d
d
d
d
d
c
c
c
c
b
b
a
"}
(43,1,1) = {"
a
b
b
b
b
b
c
d
d
d
d
d
d
d
d
d
d
d
d
d
d
d
d
d
d
d
d
d
d
d
d
d
d
d
d
d
d
d
d
e
e
e
e
e
e
e
e
e
e
e
d
d
d
d
d
d
d
d
d
d
d
d
d
d
d
d
d
d
d
d
d
d
d
c
b
b
b
b
b
a
"}
(44,1,1) = {"
a
b
b
b
b
b
c
d
d
d
d
d
d
d
d
d
d
d
d
d
d
d
d
d
d
d
d
d
d
d
d
d
d
d
d
d
d
d
d
d
d
d
d
d
e
e
e
e
e
e
e
e
e
e
d
d
d
d
d
d
d
d
d
d
d
d
d
d
d
d
d
d
d
d
b
b
b
b
b
a
"}
(45,1,1) = {"
a
b
b
c
c
c
c
d
d
d
d
d
d
d
d
d
d
d
d
d
d
d
d
d
d
d
d
d
d
d
d
d
d
d
d
d
d
d
d
d
d
d
d
d
d
e
e
e
e
e
e
e
e
e
e
e
e
d
d
d
d
d
d
d
d
d
d
d
d
d
d
d
d
d
d
b
b
b
b
a
"}
(46,1,1) = {"
a
b
b
b
b
c
d
d
d
d
d
d
d
d
d
d
d
d
d
d
d
d
d
d
d
d
d
d
d
d
d
d
d
d
d
d
d
d
d
d
d
d
d
d
d
d
d
d
d
d
d
d
d
d
d
d
d
d
d
d
d
d
d
d
d
d
d
d
d
d
d
d
d
d
d
b
b
b
b
a
"}
(47,1,1) = {"
a
b
b
b
b
L
d
d
d
d
d
d
d
d
d
d
d
d
d
d
d
d
d
d
d
d
d
d
d
d
d
d
d
d
d
d
d
d
d
d
d
d
d
d
d
d
d
d
d
d
d
d
d
d
d
d
d
d
d
d
d
d
d
d
d
d
d
d
d
d
d
d
d
d
d
d
b
b
b
a
"}
(48,1,1) = {"
a
b
b
b
b
d
d
d
d
d
d
d
d
d
d
d
d
d
d
d
d
d
d
d
d
d
d
d
d
d
d
d
d
d
d
d
d
d
d
d
d
d
d
d
d
d
d
d
d
d
d
d
d
d
d
d
d
d
d
d
d
d
d
d
d
d
d
d
d
d
d
d
d
d
d
d
b
b
b
a
"}
(49,1,1) = {"
a
b
b
b
b
d
d
d
d
d
d
d
d
d
d
d
d
d
d
d
d
d
d
d
d
d
d
d
d
d
d
d
d
d
d
d
d
d
d
d
d
d
d
d
d
d
d
d
d
d
d
d
d
d
d
d
d
d
d
d
d
d
d
e
d
d
d
d
d
d
d
d
d
d
d
c
b
b
b
a
"}
(50,1,1) = {"
a
b
b
b
b
d
d
d
d
d
d
d
d
d
d
d
d
d
d
d
d
d
d
d
d
d
d
d
d
d
d
d
d
d
d
d
d
d
d
d
d
d
d
d
d
d
d
d
d
d
d
d
d
d
d
d
d
d
d
d
d
d
d
e
e
d
d
d
d
d
d
d
d
d
c
c
c
c
b
a
"}
(51,1,1) = {"
a
b
b
b
b
d
d
d
d
d
d
d
d
d
d
d
d
d
d
d
d
d
d
d
d
d
d
d
d
d
d
d
d
d
d
d
d
d
d
d
d
d
d
d
d
d
d
d
d
d
d
d
d
d
d
d
d
d
d
d
d
d
d
d
e
e
e
d
d
d
d
d
d
d
d
c
b
b
b
a
"}
(52,1,1) = {"
a
b
b
b
b
d
d
d
d
d
d
d
d
d
d
d
d
d
d
d
d
d
d
d
d
d
d
d
d
d
d
d
d
d
d
d
d
d
d
d
d
d
d
d
d
d
d
d
d
d
d
d
d
d
d
d
d
d
d
d
d
d
d
d
e
L
e
e
d
d
d
d
d
d
d
c
b
b
b
a
"}
(53,1,1) = {"
a
b
b
b
b
d
d
d
d
d
d
d
d
d
d
d
d
d
d
d
d
d
d
d
d
e
d
d
d
d
d
d
d
d
d
d
d
d
d
d
d
d
d
d
d
d
d
d
d
d
d
d
d
d
d
d
d
d
d
d
d
d
d
d
e
L
L
L
e
d
d
d
d
d
d
c
c
b
b
a
"}
(54,1,1) = {"
a
b
b
b
b
b
d
d
d
d
d
d
d
d
d
d
d
d
d
d
d
d
L
L
L
e
e
e
e
e
d
d
d
d
d
d
d
d
d
d
d
d
d
d
d
d
d
d
d
d
d
d
d
d
d
d
d
d
d
d
d
d
d
d
e
e
L
L
e
d
d
d
d
d
d
d
b
b
b
a
"}
(55,1,1) = {"
a
b
b
b
b
b
d
d
d
d
d
d
d
d
d
d
d
d
d
d
d
d
d
d
d
L
L
L
e
e
e
e
d
d
d
d
d
d
d
d
d
d
d
d
d
d
d
d
d
d
d
d
d
d
d
d
d
d
d
d
d
d
d
d
d
d
e
L
e
d
d
d
d
d
d
d
b
b
b
a
"}
(56,1,1) = {"
a
b
b
b
b
b
b
b
d
d
d
d
d
d
d
d
d
d
d
d
d
d
d
d
d
d
L
L
L
L
e
e
d
d
d
d
d
d
d
d
d
d
d
d
d
d
d
d
d
d
d
d
d
d
d
d
d
d
d
d
d
d
d
d
d
d
e
e
e
e
e
d
d
d
d
d
b
b
b
a
"}
(57,1,1) = {"
a
b
b
b
b
b
b
c
c
c
d
d
d
d
d
d
d
d
d
d
d
d
d
d
d
d
d
d
L
e
L
L
d
d
d
d
d
d
d
d
d
d
d
d
d
d
d
d
d
d
d
d
d
d
d
d
d
d
d
d
d
d
d
d
d
d
d
d
e
e
e
d
d
d
d
d
b
b
b
a
"}
(58,1,1) = {"
a
b
b
b
b
b
b
b
b
c
d
d
d
d
d
d
d
d
d
d
d
d
d
d
d
d
d
d
d
e
e
L
L
L
d
d
d
d
d
d
d
d
d
d
d
d
d
d
d
d
d
d
d
d
d
d
d
d
d
d
d
d
d
d
d
d
d
d
d
e
e
d
d
d
d
d
b
b
b
a
"}
(59,1,1) = {"
a
b
b
b
b
b
b
b
c
c
c
d
d
d
d
d
d
d
d
d
d
d
d
d
d
d
d
d
d
d
e
e
e
L
L
L
d
d
d
d
d
d
d
d
d
d
d
d
d
d
d
d
d
d
d
d
d
d
d
d
d
d
d
d
d
d
d
d
d
d
d
d
d
d
d
d
b
b
b
a
"}
(60,1,1) = {"
a
b
b
b
b
b
b
b
b
c
L
d
d
d
d
d
d
d
d
d
d
d
d
d
d
d
d
d
d
d
d
d
e
d
d
d
d
d
d
d
d
d
d
d
d
d
d
d
d
d
d
d
d
d
d
d
d
d
d
d
d
d
d
d
d
d
d
d
d
d
d
d
d
d
d
b
b
b
b
a
"}
(61,1,1) = {"
a
b
b
b
b
b
b
b
b
c
L
d
d
d
d
d
d
d
d
d
d
d
d
d
d
d
d
d
d
d
d
d
d
d
d
d
d
d
d
d
d
d
d
d
d
d
d
d
d
d
d
d
d
d
d
d
d
d
d
d
d
d
d
d
d
d
d
d
d
d
d
d
d
d
d
b
b
b
b
a
"}
(62,1,1) = {"
a
b
b
b
b
b
b
b
b
c
L
d
d
d
d
d
d
d
d
d
d
d
d
d
d
d
d
d
d
d
d
d
d
d
d
d
d
d
d
d
d
d
d
d
d
d
d
d
d
d
d
d
d
d
d
d
d
d
d
d
d
d
d
d
d
d
d
d
d
d
d
d
d
d
d
b
b
b
b
a
"}
(63,1,1) = {"
a
b
b
b
b
b
b
b
b
c
d
d
d
d
d
d
d
d
d
d
d
d
d
d
d
d
d
d
d
d
d
d
d
d
d
d
d
d
d
d
d
d
d
d
d
d
d
d
d
d
d
d
d
d
d
d
d
d
d
d
d
d
d
d
d
d
d
d
d
d
d
d
d
d
c
b
b
b
b
a
"}
(64,1,1) = {"
a
b
b
b
b
b
b
b
b
c
d
d
d
d
d
d
d
d
d
d
d
d
d
d
d
d
d
d
d
d
d
d
d
d
d
d
d
d
d
d
d
d
d
d
d
d
d
d
d
d
d
d
d
d
d
d
d
d
d
d
d
d
d
d
d
d
d
d
d
d
d
d
d
d
c
c
b
b
b
a
"}
(65,1,1) = {"
a
b
b
b
b
b
b
b
b
b
d
d
d
d
d
d
d
d
d
d
d
d
d
d
d
d
d
d
d
d
d
d
d
d
d
d
d
d
d
d
d
d
d
d
d
d
d
d
d
d
d
d
d
d
d
d
d
d
d
d
d
d
d
d
d
d
d
d
d
d
d
d
d
d
c
b
b
b
b
a
"}
(66,1,1) = {"
a
b
b
b
b
b
b
b
b
b
b
d
d
d
d
d
d
d
d
d
d
d
d
d
d
d
d
d
d
d
d
d
d
d
d
d
d
d
d
d
d
d
d
d
d
d
d
d
d
d
d
d
d
d
d
d
d
d
d
d
d
d
d
d
d
d
d
d
d
d
d
d
d
d
c
b
b
b
b
a
"}
(67,1,1) = {"
a
b
b
b
b
b
b
b
b
b
b
b
c
d
d
d
d
d
d
d
d
d
d
d
d
d
d
d
d
d
d
d
d
d
d
d
d
d
d
d
d
d
d
d
d
d
d
d
d
d
d
d
d
d
d
d
d
d
d
d
d
d
d
d
d
d
d
d
d
d
d
d
d
d
d
b
b
b
b
a
"}
(68,1,1) = {"
a
b
b
b
b
b
b
b
b
c
c
c
c
d
d
d
d
d
d
d
d
d
d
d
d
d
d
d
d
d
d
d
d
d
d
d
d
d
d
d
d
d
d
d
d
d
d
d
d
d
d
d
d
d
d
d
d
d
d
d
d
d
d
d
d
d
d
d
d
d
d
d
d
d
b
b
b
b
b
a
"}
(69,1,1) = {"
a
b
b
b
b
b
b
b
b
b
b
b
c
d
d
d
d
d
d
d
d
d
d
d
d
d
d
d
d
d
d
d
d
d
d
d
d
d
d
d
d
d
d
d
d
d
d
d
d
d
d
d
d
d
d
d
d
d
d
d
d
d
d
d
d
d
d
d
d
d
d
d
L
L
b
b
b
b
b
a
"}
(70,1,1) = {"
a
b
b
b
b
b
b
b
b
b
b
b
c
L
L
d
d
d
d
d
d
d
d
d
d
d
d
d
d
d
d
d
d
d
d
d
d
d
d
d
d
d
d
d
d
d
d
d
d
d
d
d
d
d
d
d
d
d
d
d
d
d
d
d
d
d
d
d
c
c
c
c
c
c
c
c
b
b
b
a
"}
(71,1,1) = {"
a
b
b
b
b
b
b
b
b
b
b
b
c
b
b
b
b
d
d
d
d
d
d
d
d
d
d
d
d
d
d
d
d
d
d
d
d
d
d
d
d
d
d
d
d
d
d
d
d
d
d
d
d
d
d
d
d
d
d
d
d
d
d
d
d
d
d
L
L
L
c
b
b
b
b
b
b
b
b
a
"}
(72,1,1) = {"
a
b
b
b
b
b
b
b
b
b
b
c
c
c
b
b
b
b
c
c
d
d
d
d
d
d
d
d
d
d
d
d
d
d
d
d
d
d
d
d
d
d
d
d
d
d
d
d
d
d
d
d
d
d
d
d
d
d
d
d
d
d
d
d
d
d
c
L
b
b
c
b
b
b
b
b
b
b
b
a
"}
(73,1,1) = {"
a
b
b
b
b
b
b
b
b
b
b
b
c
b
b
b
b
b
b
c
d
d
d
d
d
d
d
d
d
d
d
d
d
d
d
d
d
d
d
d
d
d
d
d
d
d
d
d
d
d
d
d
d
d
d
d
d
d
d
d
d
d
d
d
d
d
c
c
b
b
c
b
b
b
b
b
b
b
b
a
"}
(74,1,1) = {"
a
b
b
b
b
b
b
b
b
b
b
b
c
b
b
b
b
b
b
b
b
d
d
d
d
d
d
d
d
d
d
d
d
d
d
d
d
d
d
d
d
d
d
d
d
d
d
d
d
d
d
d
d
d
d
d
d
d
d
d
d
d
d
d
d
L
c
b
b
b
b
b
b
b
b
b
b
b
b
a
"}
(75,1,1) = {"
a
b
b
b
b
b
b
b
b
b
b
b
c
b
b
b
b
b
b
b
b
b
b
c
d
d
d
d
d
d
d
d
d
d
d
d
d
d
d
d
d
d
d
d
d
d
b
b
b
c
c
c
d
d
d
d
d
d
d
d
d
d
d
c
c
b
c
b
b
b
b
b
b
b
b
b
b
b
b
a
"}
(76,1,1) = {"
a
b
b
b
b
b
b
b
b
b
b
b
b
b
b
b
b
b
b
c
c
c
c
c
c
c
c
d
d
d
d
d
d
d
d
d
d
d
d
d
d
L
c
c
b
b
b
b
b
c
c
L
L
c
c
d
d
d
d
c
c
c
b
b
b
b
c
b
b
b
b
b
b
b
b
b
b
b
b
a
"}
(77,1,1) = {"
a
b
b
b
b
b
b
b
b
b
b
b
b
b
b
b
b
b
b
b
b
b
b
c
b
b
b
b
c
c
c
d
d
d
d
d
d
d
d
c
c
c
c
c
c
c
b
b
b
b
c
b
b
b
c
L
L
d
d
c
b
b
b
b
b
b
b
b
b
b
b
b
b
b
b
b
b
b
b
a
"}
(78,1,1) = {"
a
b
b
b
b
b
b
b
b
b
b
b
b
b
b
b
b
b
b
b
b
b
b
c
b
b
b
b
b
b
b
b
d
d
d
d
L
c
b
b
b
b
b
c
b
b
b
b
b
b
c
b
b
b
c
b
b
b
b
c
b
b
b
b
b
b
b
b
b
b
b
b
b
b
b
b
b
b
b
a
"}
(79,1,1) = {"
a
b
b
b
b
b
b
b
b
b
b
b
b
b
b
b
b
b
b
b
b
b
b
b
b
b
b
b
b
b
b
b
b
b
b
b
b
b
b
b
b
b
b
b
b
b
b
b
b
b
b
b
b
b
c
b
b
b
b
b
b
b
b
b
b
b
b
b
b
b
b
b
b
b
b
b
b
b
b
a
"}
(80,1,1) = {"
a
a
a
a
a
a
a
a
a
a
a
a
a
a
a
a
a
a
a
a
a
a
a
a
a
a
a
a
a
a
a
a
a
a
a
a
a
a
a
a
a
a
a
a
a
a
a
a
a
a
a
a
a
a
a
a
a
a
a
a
a
a
a
a
a
a
a
a
a
a
a
a
a
a
a
a
a
a
a
a
"}
