//MAP CONVERTED BY dmm2tgm.py THIS HEADER COMMENT PREVENTS RECONVERSION, DO NOT REMOVE
"a" = (
/turf/template_noop,
/area/submap/outpost21/asteroid_generic)
"x" = (
/turf/simulated/mineral/vacuum,
/area/submap/outpost21/asteroid_generic)
"M" = (
/turf/template_noop,
/area/template_noop)
"O" = (
/turf/simulated/mineral/floor/vacuum,
/area/submap/outpost21/asteroid_generic)
"T" = (
/obj/structure/lattice,
/turf/space,
/area/submap/outpost21/asteroid_generic)

(1,1,1) = {"
M
M
M
M
M
M
M
M
M
M
M
M
M
M
M
M
M
M
M
M
M
M
M
M
M
M
M
M
M
M
M
M
M
M
M
M
M
M
M
M
M
M
M
M
M
M
M
M
M
M
M
M
M
M
M
"}
(2,1,1) = {"
M
a
a
a
a
a
a
a
a
a
a
a
a
a
a
a
a
a
a
a
a
a
a
a
a
a
a
a
a
a
a
a
a
a
a
a
a
a
a
a
a
a
a
a
a
a
a
a
a
a
a
a
a
a
M
"}
(3,1,1) = {"
M
a
a
a
a
a
a
a
a
a
a
a
a
a
a
a
a
a
a
a
a
a
a
a
a
a
a
T
a
a
a
a
a
a
a
a
a
a
a
a
T
a
a
a
a
a
a
a
a
a
a
a
a
a
M
"}
(4,1,1) = {"
M
a
a
a
a
a
a
a
a
a
a
a
a
a
a
a
a
a
x
x
x
x
x
x
x
x
x
T
x
x
x
x
x
x
x
x
a
a
a
T
T
a
a
a
a
a
a
a
a
a
a
a
a
a
M
"}
(5,1,1) = {"
M
a
a
a
a
a
a
a
a
a
a
a
a
a
a
x
x
x
x
x
x
x
x
x
x
x
x
x
x
x
x
x
x
x
x
x
x
x
x
x
x
a
a
a
a
a
a
a
a
a
a
a
a
a
M
"}
(6,1,1) = {"
M
a
a
a
a
a
a
a
a
a
a
a
a
x
x
x
x
x
x
x
x
x
x
x
x
x
x
x
x
x
x
x
x
x
x
x
x
x
x
x
x
x
x
x
a
a
a
a
T
a
a
a
a
a
M
"}
(7,1,1) = {"
M
a
a
a
a
a
a
a
T
T
T
T
x
x
x
x
x
x
x
x
x
x
x
x
x
x
x
x
x
x
x
x
x
x
x
x
x
x
x
x
x
x
x
x
x
a
a
a
T
a
a
a
a
a
M
"}
(8,1,1) = {"
M
a
a
a
a
a
a
a
a
a
x
x
x
x
x
x
x
x
x
x
x
x
x
x
x
x
x
x
x
x
x
x
x
x
x
x
x
x
x
x
x
x
x
x
x
x
x
T
T
T
a
a
a
a
M
"}
(9,1,1) = {"
M
a
a
a
a
a
a
a
a
a
x
x
x
x
x
x
x
x
O
O
x
x
x
x
x
x
x
x
x
x
x
x
x
x
x
x
x
x
x
x
x
x
x
x
x
x
x
x
T
a
a
a
a
a
M
"}
(10,1,1) = {"
M
a
a
a
a
a
a
a
x
x
x
x
x
x
x
x
x
O
O
O
O
x
x
x
x
x
x
x
x
x
x
x
x
x
x
x
x
x
x
x
x
x
x
x
O
O
x
x
x
a
a
a
a
a
M
"}
(11,1,1) = {"
M
a
a
a
a
a
x
x
x
x
x
x
x
x
x
x
O
O
O
O
x
x
x
x
x
x
x
x
x
x
x
x
x
x
x
x
O
O
O
O
x
x
x
O
O
O
x
x
x
x
a
a
a
a
M
"}
(12,1,1) = {"
M
a
a
a
a
x
x
x
x
x
x
x
x
x
O
O
O
O
O
x
x
x
x
x
x
x
x
x
x
x
x
x
x
x
x
x
x
O
O
O
O
O
O
O
O
x
x
x
x
x
a
a
a
a
M
"}
(13,1,1) = {"
M
a
a
a
a
x
x
x
x
x
x
x
x
x
x
O
O
O
x
x
x
x
x
x
x
x
x
x
x
x
x
x
x
x
x
x
x
x
O
O
O
O
O
O
x
x
x
x
x
x
a
a
a
a
M
"}
(14,1,1) = {"
M
a
a
a
a
x
x
x
x
x
x
x
x
x
x
x
x
x
x
x
x
x
x
x
x
x
x
x
x
x
x
x
x
x
x
x
x
x
x
O
O
O
O
x
x
x
x
x
x
x
x
a
a
a
M
"}
(15,1,1) = {"
M
a
a
a
a
x
x
x
x
x
x
x
x
x
x
x
x
x
x
x
x
x
x
x
x
x
x
x
x
x
x
x
x
x
x
x
x
x
x
x
O
O
x
x
x
x
x
x
x
x
a
a
a
a
M
"}
(16,1,1) = {"
M
a
a
T
T
T
x
x
x
x
x
x
x
x
x
x
x
x
x
x
x
x
x
x
x
x
x
x
x
x
x
x
x
x
x
x
x
x
x
x
x
x
x
x
x
x
x
x
x
T
T
T
a
a
M
"}
(17,1,1) = {"
M
a
a
a
a
T
x
x
x
x
x
x
x
x
x
x
x
x
x
x
x
x
x
x
x
x
x
x
x
x
x
x
x
x
x
x
x
x
x
x
x
x
x
x
x
x
x
x
x
a
a
a
a
a
M
"}
(18,1,1) = {"
M
a
a
a
a
a
a
x
x
x
x
x
x
x
x
x
x
x
x
x
x
x
x
x
x
x
x
x
x
x
x
x
x
x
x
x
x
x
x
x
x
x
x
x
x
x
x
x
a
a
a
a
a
a
M
"}
(19,1,1) = {"
M
a
a
a
a
a
a
x
x
x
x
x
x
x
x
x
x
x
x
x
x
x
x
x
x
x
x
x
x
x
x
x
x
x
x
x
x
x
x
x
T
x
x
x
x
x
a
a
a
a
a
a
a
a
M
"}
(20,1,1) = {"
M
a
a
a
a
a
a
a
x
x
x
x
x
x
x
x
x
x
x
x
x
x
x
x
x
x
x
x
x
x
x
x
x
x
x
x
x
x
x
x
a
a
a
a
a
a
a
a
a
a
a
a
a
a
M
"}
(21,1,1) = {"
M
a
a
a
a
a
a
a
a
a
a
x
x
x
x
x
x
x
x
x
x
x
x
x
x
x
x
x
x
x
x
x
x
x
a
a
a
T
T
a
a
a
a
a
a
a
a
a
a
a
a
a
a
a
M
"}
(22,1,1) = {"
M
a
a
a
a
a
a
a
a
a
a
a
T
T
a
x
x
x
x
x
x
x
x
x
x
x
x
x
x
x
x
x
a
a
a
a
a
a
T
a
a
a
a
a
a
a
a
a
a
a
a
a
a
a
M
"}
(23,1,1) = {"
M
a
a
a
a
a
a
a
a
a
a
a
a
T
a
a
a
a
a
a
x
x
x
x
x
x
x
x
x
x
x
x
a
a
a
a
a
a
T
a
a
a
a
a
a
a
a
a
a
a
a
a
a
a
M
"}
(24,1,1) = {"
M
M
M
M
M
M
M
M
M
M
M
M
M
M
M
M
M
M
M
M
M
M
M
M
M
M
M
M
M
M
M
M
M
M
M
M
M
M
M
M
M
M
M
M
M
M
M
M
M
M
M
M
M
M
M
"}
