//MAP CONVERTED BY dmm2tgm.py THIS HEADER COMMENT PREVENTS RECONVERSION, DO NOT REMOVE
"a" = (
/turf/simulated/mineral/vacuum,
/area/submap/outpost21/asteroid_generic)
"e" = (
/turf/template_noop,
/area/template_noop)
"f" = (
/turf/template_noop,
/area/submap/outpost21/asteroid_generic)
"t" = (
/turf/simulated/mineral/floor/vacuum,
/area/submap/outpost21/asteroid_generic)
"K" = (
/obj/structure/lattice,
/turf/space,
/area/submap/outpost21/asteroid_generic)

(1,1,1) = {"
e
e
e
e
e
e
e
e
e
e
e
e
e
e
e
e
e
e
e
e
e
e
e
e
e
"}
(2,1,1) = {"
e
f
f
f
f
f
f
f
f
f
a
a
a
a
f
f
f
f
f
f
f
f
f
f
e
"}
(3,1,1) = {"
e
f
f
f
f
f
f
f
a
a
a
a
a
a
a
f
f
f
f
f
f
f
f
f
e
"}
(4,1,1) = {"
e
f
f
f
f
f
a
a
a
a
a
a
a
a
a
a
f
f
f
f
f
f
f
f
e
"}
(5,1,1) = {"
e
f
f
f
f
a
a
a
a
a
a
a
t
t
a
a
a
f
f
f
f
f
f
f
e
"}
(6,1,1) = {"
e
f
f
f
a
a
a
a
a
a
a
a
t
t
a
a
a
a
f
f
f
f
f
f
e
"}
(7,1,1) = {"
e
f
f
f
a
a
a
a
a
a
a
a
t
a
a
a
a
a
f
f
f
f
f
f
e
"}
(8,1,1) = {"
e
f
f
a
a
a
a
a
a
a
a
a
a
a
a
a
a
a
f
f
f
f
f
f
e
"}
(9,1,1) = {"
e
f
f
a
a
a
a
a
a
a
a
a
a
a
a
a
a
a
a
f
f
f
f
f
e
"}
(10,1,1) = {"
e
f
f
a
a
a
a
a
a
a
a
a
a
a
a
a
a
a
a
f
f
f
f
f
e
"}
(11,1,1) = {"
e
f
f
a
a
a
a
a
a
a
a
a
a
a
a
a
a
a
a
a
f
f
f
f
e
"}
(12,1,1) = {"
e
f
f
f
a
a
a
a
a
a
a
a
a
a
a
a
a
a
a
a
f
f
f
f
e
"}
(13,1,1) = {"
e
f
f
f
a
a
a
a
a
a
a
a
a
a
a
a
a
a
a
a
f
f
f
f
e
"}
(14,1,1) = {"
e
f
f
f
a
a
a
a
a
a
a
a
a
a
a
a
a
a
a
a
a
f
f
f
e
"}
(15,1,1) = {"
e
f
f
f
a
a
a
a
a
a
a
a
a
a
a
a
a
a
a
a
a
K
K
f
e
"}
(16,1,1) = {"
e
f
f
f
a
a
a
a
a
t
t
t
a
a
a
a
a
a
a
a
a
K
f
f
e
"}
(17,1,1) = {"
e
f
f
f
a
a
a
a
a
a
t
t
t
t
a
a
a
a
a
a
a
f
f
f
e
"}
(18,1,1) = {"
e
f
K
K
K
a
a
a
a
a
a
a
t
t
t
a
a
a
a
a
a
f
f
f
e
"}
(19,1,1) = {"
e
f
f
f
f
a
a
a
a
a
a
a
a
t
t
t
a
a
a
a
a
f
f
f
e
"}
(20,1,1) = {"
e
f
f
f
f
a
a
a
a
a
a
a
a
t
t
t
t
a
a
a
f
f
f
f
e
"}
(21,1,1) = {"
e
f
f
f
f
a
a
a
a
a
a
a
t
t
t
t
t
a
a
a
f
f
f
f
e
"}
(22,1,1) = {"
e
f
f
f
f
a
a
a
a
a
a
t
t
t
t
t
a
a
a
a
a
f
f
f
e
"}
(23,1,1) = {"
e
f
f
f
f
a
a
a
a
a
a
t
t
t
t
t
a
a
a
a
a
f
f
f
e
"}
(24,1,1) = {"
e
f
f
f
a
a
a
a
a
a
t
t
t
t
t
t
a
a
a
a
a
a
f
f
e
"}
(25,1,1) = {"
e
f
f
f
a
a
a
a
a
a
t
t
t
t
t
t
a
a
a
a
a
a
f
f
e
"}
(26,1,1) = {"
e
f
f
a
a
a
a
a
a
a
a
t
t
t
a
a
a
a
a
a
a
a
f
f
e
"}
(27,1,1) = {"
e
f
a
a
a
a
a
a
a
a
a
t
t
a
a
a
a
a
a
a
a
a
f
f
e
"}
(28,1,1) = {"
e
f
a
a
a
a
a
a
a
a
a
a
a
a
a
a
a
a
a
a
a
a
f
f
e
"}
(29,1,1) = {"
e
f
a
a
a
a
a
a
a
a
a
a
a
a
a
a
a
a
a
a
a
a
f
f
e
"}
(30,1,1) = {"
e
a
a
a
a
a
a
a
a
a
a
a
a
a
a
a
a
a
a
a
a
a
f
f
e
"}
(31,1,1) = {"
e
a
a
a
a
a
a
a
a
a
a
a
a
a
a
a
a
a
a
a
a
f
f
f
e
"}
(32,1,1) = {"
e
a
a
a
a
a
a
a
a
a
a
a
a
a
a
a
a
a
a
a
a
a
f
f
e
"}
(33,1,1) = {"
e
a
a
a
a
a
a
a
a
a
a
a
a
a
a
a
a
a
a
a
a
a
f
f
e
"}
(34,1,1) = {"
e
a
a
a
a
a
a
a
a
a
a
a
a
a
a
a
a
a
a
a
a
a
f
f
e
"}
(35,1,1) = {"
e
a
a
a
a
a
a
a
a
a
a
a
a
a
a
a
a
a
a
a
a
a
f
f
e
"}
(36,1,1) = {"
e
a
a
a
a
a
a
a
a
a
a
a
a
a
a
a
a
a
a
a
a
f
f
f
e
"}
(37,1,1) = {"
e
a
a
a
a
a
a
a
a
a
a
a
a
a
a
a
a
a
a
a
a
f
f
f
e
"}
(38,1,1) = {"
e
f
a
a
a
a
a
a
a
a
a
a
a
a
a
a
a
a
a
a
a
f
f
f
e
"}
(39,1,1) = {"
e
f
f
f
a
a
a
a
a
a
a
a
a
a
a
a
a
a
a
a
f
f
f
f
e
"}
(40,1,1) = {"
e
f
f
f
a
a
a
a
a
a
a
a
a
a
a
a
a
a
K
f
f
f
f
f
e
"}
(41,1,1) = {"
e
f
f
f
f
a
a
a
a
a
a
a
a
a
a
a
a
a
a
f
f
f
f
f
e
"}
(42,1,1) = {"
e
f
f
f
f
a
a
a
a
a
a
a
t
t
t
a
a
a
a
a
f
f
f
f
e
"}
(43,1,1) = {"
e
f
f
f
f
a
a
a
a
a
a
t
t
t
t
a
a
a
a
a
f
f
f
f
e
"}
(44,1,1) = {"
e
f
f
f
f
a
a
a
a
a
a
t
t
t
t
a
a
a
a
a
f
f
f
f
e
"}
(45,1,1) = {"
e
f
f
K
K
K
a
a
a
a
t
t
t
t
a
a
a
a
a
a
a
f
f
f
e
"}
(46,1,1) = {"
e
f
f
f
f
K
a
a
a
a
t
t
t
a
a
a
a
a
a
a
f
f
f
f
e
"}
(47,1,1) = {"
e
f
f
f
f
f
a
a
a
a
a
a
a
a
a
a
a
a
a
K
K
K
f
f
e
"}
(48,1,1) = {"
e
f
f
f
f
f
a
a
a
a
a
a
a
a
a
a
a
a
a
f
f
f
f
f
e
"}
(49,1,1) = {"
e
f
f
f
f
f
f
a
a
a
a
a
a
a
a
a
a
a
f
f
f
f
f
f
e
"}
(50,1,1) = {"
e
f
f
f
f
f
f
a
a
a
a
a
a
a
a
a
a
f
f
f
f
f
f
f
e
"}
(51,1,1) = {"
e
f
f
f
f
f
f
a
a
a
a
a
a
a
a
a
a
f
f
f
f
f
f
f
e
"}
(52,1,1) = {"
e
f
f
f
f
f
f
f
a
a
a
a
a
a
f
f
f
f
f
f
f
f
f
f
e
"}
(53,1,1) = {"
e
f
f
f
f
f
f
f
f
f
f
f
f
f
f
f
f
f
f
f
f
f
f
f
e
"}
(54,1,1) = {"
e
f
f
f
f
f
f
f
f
f
f
f
f
f
f
f
f
f
f
f
f
f
f
f
e
"}
(55,1,1) = {"
e
e
e
e
e
e
e
e
e
e
e
e
e
e
e
e
e
e
e
e
e
e
e
e
e
"}
