//MAP CONVERTED BY dmm2tgm.py THIS HEADER COMMENT PREVENTS RECONVERSION, DO NOT REMOVE
"a" = (
/turf/template_noop,
/area/template_noop)
"c" = (
/obj/effect/floor_decal/industrial/warning{
	dir = 1
	},
/turf/simulated/floor/tiled/airless,
/area/submap/outpost21/asteroid_generic)
"f" = (
/obj/effect/floor_decal/industrial/warning{
	dir = 8
	},
/turf/simulated/floor/tiled/airless,
/area/submap/outpost21/asteroid_generic)
"g" = (
/obj/machinery/trailblazer/yellow,
/turf/simulated/floor/airless,
/area/submap/outpost21/asteroid_generic)
"j" = (
/obj/structure/handrail{
	dir = 8
	},
/turf/simulated/floor/airless,
/area/submap/outpost21/asteroid_generic)
"m" = (
/obj/effect/floor_decal/industrial/warning{
	dir = 4
	},
/turf/simulated/floor/tiled/airless,
/area/submap/outpost21/asteroid_generic)
"r" = (
/obj/structure/handrail{
	dir = 4
	},
/turf/simulated/floor/airless,
/area/submap/outpost21/asteroid_generic)
"s" = (
/obj/effect/floor_decal/industrial/warning{
	dir = 6
	},
/turf/simulated/floor/tiled/airless,
/area/submap/outpost21/asteroid_generic)
"t" = (
/obj/structure/dispenser,
/obj/effect/floor_decal/industrial/warning{
	dir = 9
	},
/turf/simulated/floor/tiled/airless,
/area/submap/outpost21/asteroid_generic)
"w" = (
/turf/simulated/floor/airless,
/area/submap/outpost21/asteroid_generic)
"x" = (
/turf/simulated/wall,
/area/submap/outpost21/asteroid_generic)
"y" = (
/obj/effect/floor_decal/industrial/warning,
/turf/simulated/floor/tiled/airless,
/area/submap/outpost21/asteroid_generic)
"A" = (
/obj/structure/lattice,
/turf/space,
/area/submap/outpost21/asteroid_generic)
"C" = (
/turf/simulated/floor/tiled/airless,
/area/submap/outpost21/asteroid_generic)
"E" = (
/obj/structure/lattice,
/obj/structure/handrail{
	dir = 4
	},
/turf/space,
/area/submap/outpost21/asteroid_generic)
"H" = (
/obj/random/firstaid,
/obj/structure/table/steel,
/obj/effect/floor_decal/industrial/warning{
	dir = 5
	},
/turf/simulated/floor/tiled/airless,
/area/submap/outpost21/asteroid_generic)
"M" = (
/turf/template_noop,
/area/submap/outpost21/asteroid_generic)
"R" = (
/obj/structure/reagent_dispensers/fueltank,
/obj/effect/floor_decal/industrial/warning{
	dir = 10
	},
/turf/simulated/floor/tiled/airless,
/area/submap/outpost21/asteroid_generic)
"S" = (
/obj/structure/lattice,
/obj/structure/handrail{
	dir = 8
	},
/turf/space,
/area/submap/outpost21/asteroid_generic)
"T" = (
/turf/space,
/area/submap/outpost21/asteroid_generic)

(1,1,1) = {"
a
a
a
a
a
a
a
a
a
a
a
a
"}
(2,1,1) = {"
a
M
M
T
T
T
T
T
w
w
M
a
"}
(3,1,1) = {"
a
M
g
w
A
T
T
A
A
g
M
a
"}
(4,1,1) = {"
a
M
A
w
S
w
j
A
T
T
M
a
"}
(5,1,1) = {"
a
A
A
x
x
C
x
x
A
A
M
a
"}
(6,1,1) = {"
a
T
A
x
t
f
R
x
T
T
M
a
"}
(7,1,1) = {"
a
T
A
C
c
C
y
w
T
T
M
a
"}
(8,1,1) = {"
a
T
A
A
H
m
s
A
A
A
M
a
"}
(9,1,1) = {"
a
M
w
x
x
C
x
x
T
M
M
a
"}
(10,1,1) = {"
a
M
g
A
r
A
E
A
A
g
M
a
"}
(11,1,1) = {"
a
M
w
A
T
A
T
T
w
w
M
a
"}
(12,1,1) = {"
a
a
a
a
a
a
a
a
a
a
a
a
"}
