//MAP CONVERTED BY dmm2tgm.py THIS HEADER COMMENT PREVENTS RECONVERSION, DO NOT REMOVE
"a" = (
/turf/template_noop,
/area/template_noop)
"b" = (
/turf/template_noop,
/area/submap/outpost21/asteroid_generic)
"c" = (
/turf/simulated/mineral/vacuum,
/area/submap/outpost21/asteroid_generic)
"d" = (
/obj/structure/lattice,
/turf/space,
/area/submap/outpost21/asteroid_generic)
"V" = (
/turf/space,
/area/submap/outpost21/asteroid_generic)

(1,1,1) = {"
a
a
a
a
a
a
a
a
a
a
a
a
a
a
a
a
a
a
a
a
"}
(2,1,1) = {"
a
b
b
b
b
b
b
b
b
b
b
b
b
b
b
b
b
b
b
a
"}
(3,1,1) = {"
a
b
b
c
d
d
d
d
b
b
b
b
b
b
c
c
b
b
b
a
"}
(4,1,1) = {"
a
b
b
c
c
d
V
V
V
V
V
V
V
c
c
c
c
b
b
a
"}
(5,1,1) = {"
a
b
b
c
c
d
V
V
V
V
d
d
d
c
c
c
c
b
b
a
"}
(6,1,1) = {"
a
b
b
V
V
d
d
c
c
V
V
V
V
d
d
V
b
b
b
a
"}
(7,1,1) = {"
a
b
b
V
V
V
c
c
c
c
c
c
c
d
V
V
b
b
b
a
"}
(8,1,1) = {"
a
b
b
b
d
c
c
c
c
c
c
c
c
c
V
V
b
b
b
a
"}
(9,1,1) = {"
a
b
b
b
V
c
c
c
c
c
c
c
c
c
c
d
b
b
b
a
"}
(10,1,1) = {"
a
b
b
b
V
c
c
c
c
c
c
c
c
c
c
d
V
b
b
a
"}
(11,1,1) = {"
a
b
b
V
d
c
c
c
c
c
c
c
c
c
c
d
V
b
b
a
"}
(12,1,1) = {"
a
b
b
V
d
V
c
c
c
c
c
c
c
c
c
d
d
b
b
a
"}
(13,1,1) = {"
a
b
b
d
d
V
d
d
c
c
c
c
d
V
V
d
b
b
b
a
"}
(14,1,1) = {"
a
b
c
c
d
d
d
d
c
c
c
V
d
V
V
d
b
b
b
a
"}
(15,1,1) = {"
a
b
c
c
d
V
d
V
V
d
d
d
d
d
d
d
d
b
b
a
"}
(16,1,1) = {"
a
b
b
c
d
V
c
c
c
c
c
c
c
c
c
V
b
b
b
a
"}
(17,1,1) = {"
a
b
b
b
d
V
c
c
c
c
c
c
c
c
b
b
b
b
b
a
"}
(18,1,1) = {"
a
b
b
b
b
b
b
c
c
c
c
c
b
b
b
b
b
b
b
a
"}
(19,1,1) = {"
a
b
b
b
b
b
b
b
b
b
b
b
b
b
b
b
b
b
b
a
"}
(20,1,1) = {"
a
a
a
a
a
a
a
a
a
a
a
a
a
a
a
a
a
a
a
a
"}
