//MAP CONVERTED BY dmm2tgm.py THIS HEADER COMMENT PREVENTS RECONVERSION, DO NOT REMOVE
"a" = (
/turf/template_noop,
/area/template_noop)
"b" = (
/turf/template_noop,
/area/submap/outpost21/asteroid_generic)
"c" = (
/obj/structure/lattice,
/turf/space,
/area/submap/outpost21/asteroid_generic)
"d" = (
/turf/simulated/mineral/vacuum,
/area/submap/outpost21/asteroid_generic)
"C" = (
/turf/space,
/area/submap/outpost21/asteroid_generic)

(1,1,1) = {"
a
a
a
a
a
a
a
a
a
a
a
a
a
a
a
"}
(2,1,1) = {"
a
b
b
b
b
b
b
b
b
b
b
b
b
b
a
"}
(3,1,1) = {"
a
b
b
b
b
c
b
b
b
b
b
b
b
b
a
"}
(4,1,1) = {"
a
b
b
b
b
c
b
b
b
b
b
b
b
b
a
"}
(5,1,1) = {"
a
b
b
b
C
c
c
c
C
C
b
b
b
b
a
"}
(6,1,1) = {"
a
b
b
c
c
c
d
d
c
c
C
b
b
b
a
"}
(7,1,1) = {"
a
b
b
C
C
d
d
d
d
d
d
C
b
b
a
"}
(8,1,1) = {"
a
b
b
C
d
d
d
d
d
d
d
d
b
b
a
"}
(9,1,1) = {"
a
b
b
C
d
d
d
d
d
d
c
c
c
b
a
"}
(10,1,1) = {"
a
b
b
b
C
d
d
d
d
d
C
c
b
b
a
"}
(11,1,1) = {"
a
b
b
b
b
c
c
d
d
C
C
c
b
b
a
"}
(12,1,1) = {"
a
b
b
b
b
b
c
d
d
C
b
c
b
b
a
"}
(13,1,1) = {"
a
b
b
b
b
b
b
b
b
b
b
b
b
b
a
"}
(14,1,1) = {"
a
b
b
b
b
b
b
b
b
b
b
b
b
b
a
"}
(15,1,1) = {"
a
a
a
a
a
a
a
a
a
a
a
a
a
a
a
"}
