//MAP CONVERTED BY dmm2tgm.py THIS HEADER COMMENT PREVENTS RECONVERSION, DO NOT REMOVE
"a" = (
/turf/template_noop,
/area/template_noop)
"b" = (
/turf/template_noop,
/area/submap/outpost21/asteroid_generic)
"c" = (
/obj/structure/lattice,
/turf/space,
/area/submap/outpost21/asteroid_generic)
"d" = (
/turf/simulated/mineral/vacuum,
/area/submap/outpost21/asteroid_generic)
"i" = (
/turf/space,
/area/submap/outpost21/asteroid_generic)

(1,1,1) = {"
a
a
a
a
a
a
a
a
a
a
a
a
a
a
a
a
a
a
a
a
"}
(2,1,1) = {"
a
b
b
b
b
b
b
b
b
b
b
b
b
b
b
b
b
b
b
a
"}
(3,1,1) = {"
a
b
b
b
b
b
b
b
c
b
b
b
c
c
c
c
b
b
b
a
"}
(4,1,1) = {"
a
b
c
i
c
i
i
i
c
i
i
d
d
d
d
d
d
c
b
a
"}
(5,1,1) = {"
a
i
c
d
d
d
d
c
c
c
d
d
d
d
d
d
d
i
b
a
"}
(6,1,1) = {"
a
i
d
d
d
d
d
d
d
i
d
d
d
d
d
d
d
d
b
a
"}
(7,1,1) = {"
a
i
d
d
d
d
d
d
d
i
d
d
d
d
i
i
c
i
b
a
"}
(8,1,1) = {"
a
i
i
d
d
d
d
d
d
d
c
c
c
c
i
c
c
i
b
a
"}
(9,1,1) = {"
a
i
i
d
d
d
d
d
d
d
d
c
i
i
d
d
c
c
b
a
"}
(10,1,1) = {"
a
i
d
d
d
d
d
d
d
d
d
c
i
d
d
d
c
b
b
a
"}
(11,1,1) = {"
a
i
d
d
d
d
d
d
d
c
c
c
c
d
d
d
c
b
b
a
"}
(12,1,1) = {"
a
b
i
d
d
d
d
d
d
d
c
i
i
i
i
i
c
b
b
a
"}
(13,1,1) = {"
a
b
i
d
d
d
d
d
d
d
i
i
i
i
i
c
i
b
b
a
"}
(14,1,1) = {"
a
b
c
d
d
d
d
d
d
d
d
c
i
i
i
d
d
i
b
a
"}
(15,1,1) = {"
a
b
c
c
d
d
d
d
d
d
d
c
i
i
d
d
d
d
b
a
"}
(16,1,1) = {"
a
b
b
i
d
d
d
d
d
d
d
c
i
c
d
d
d
d
b
a
"}
(17,1,1) = {"
a
b
b
i
i
d
d
d
d
d
d
c
c
i
c
c
i
b
b
a
"}
(18,1,1) = {"
a
b
b
c
c
c
c
d
d
d
i
i
i
i
i
i
b
b
b
a
"}
(19,1,1) = {"
a
b
b
b
b
b
b
i
i
i
i
b
b
b
b
b
b
b
b
a
"}
(20,1,1) = {"
a
a
a
a
a
a
a
a
a
a
a
a
a
a
a
a
a
a
a
a
"}
