//MAP CONVERTED BY dmm2tgm.py THIS HEADER COMMENT PREVENTS RECONVERSION, DO NOT REMOVE
"aX" = (
/obj/machinery/atmospherics/unary/freezer{
	icon_state = "freezer"
	},
/obj/effect/floor_decal/industrial/hatch/yellow,
/turf/simulated/floor/tiled/milspec/sterile,
/area/submap/outpost21/structure_generic)
"bo" = (
/obj/effect/floor_decal/corner/blue{
	dir = 10
	},
/obj/random/trash_pile,
/turf/simulated/floor/tiled/airless,
/area/submap/outpost21/structure_generic)
"bA" = (
/obj/structure/medical_stand,
/obj/effect/floor_decal/corner/blue{
	dir = 1
	},
/turf/simulated/floor/tiled/airless,
/area/submap/outpost21/structure_generic)
"bS" = (
/turf/simulated/floor/tiled/white/airless,
/area/submap/outpost21/structure_generic)
"cA" = (
/obj/machinery/door/airlock/glass_medical,
/obj/structure/disposalpipe/segment,
/obj/machinery/door/firedoor/border_only,
/turf/simulated/floor/tiled/airless,
/area/submap/outpost21/structure_generic)
"dg" = (
/turf/simulated/floor/tiled/airless,
/area/submap/outpost21/structure_generic)
"dn" = (
/obj/machinery/atmospherics/pipe/simple/hidden{
	dir = 4
	},
/obj/effect/floor_decal/corner/blue{
	dir = 4
	},
/turf/simulated/floor/tiled/airless,
/area/submap/outpost21/structure_generic)
"dD" = (
/obj/effect/floor_decal/corner/blue{
	dir = 10
	},
/obj/structure/table/glass,
/obj/machinery/alarm{
	dir = 1;
	pixel_y = -26
	},
/obj/structure/disposalpipe/segment{
	dir = 4
	},
/obj/random/medical,
/turf/simulated/floor/tiled/airless,
/area/submap/outpost21/structure_generic)
"ef" = (
/obj/random/trash_pile,
/turf/simulated/floor/tiled/airless,
/area/submap/outpost21/structure_generic)
"er" = (
/obj/effect/floor_decal/corner/blue{
	dir = 10
	},
/obj/machinery/atmospherics/unary/vent_pump/on{
	dir = 1
	},
/turf/simulated/floor/tiled/airless,
/area/submap/outpost21/structure_generic)
"fh" = (
/obj/effect/floor_decal/corner/blue{
	dir = 9
	},
/obj/structure/table/glass,
/obj/item/reagent_containers/glass/beaker/vial/random,
/obj/item/reagent_containers/glass/beaker/vial/random,
/obj/item/reagent_containers/glass/beaker/vial/random,
/turf/simulated/floor/tiled/airless,
/area/submap/outpost21/structure_generic)
"fp" = (
/obj/machinery/door/airlock/glass_medical,
/obj/machinery/atmospherics/pipe/simple/hidden/supply{
	dir = 4
	},
/obj/machinery/atmospherics/pipe/simple/hidden/scrubbers{
	dir = 4
	},
/obj/structure/disposalpipe/segment{
	dir = 4
	},
/obj/machinery/door/firedoor/border_only,
/turf/simulated/floor/tiled/white/airless,
/area/submap/outpost21/structure_generic)
"fy" = (
/obj/random/trash_pile,
/turf/simulated/floor/airless,
/area/submap/outpost21/structure_generic)
"fE" = (
/obj/machinery/atmospherics/pipe/manifold/hidden,
/obj/effect/floor_decal/corner/blue{
	dir = 5
	},
/turf/simulated/floor/tiled/airless,
/area/submap/outpost21/structure_generic)
"fI" = (
/obj/machinery/atmospherics/pipe/simple/hidden/scrubbers,
/obj/machinery/atmospherics/pipe/simple/hidden/supply,
/obj/structure/disposalpipe/segment,
/turf/simulated/floor/tiled/airless,
/area/submap/outpost21/structure_generic)
"ge" = (
/obj/machinery/atmospherics/pipe/simple/hidden{
	dir = 9
	},
/obj/effect/floor_decal/corner/blue{
	dir = 5
	},
/turf/simulated/floor/tiled/airless,
/area/submap/outpost21/structure_generic)
"gD" = (
/obj/machinery/atmospherics/unary/vent_scrubber/on,
/turf/simulated/floor/tiled/white/airless,
/area/submap/outpost21/structure_generic)
"hc" = (
/obj/machinery/door/airlock/glass_medical,
/obj/machinery/door/firedoor/border_only,
/turf/simulated/floor/tiled/airless,
/area/submap/outpost21/structure_generic)
"hB" = (
/obj/machinery/atmospherics/pipe/manifold/hidden{
	dir = 8
	},
/obj/effect/floor_decal/corner/blue{
	dir = 5
	},
/obj/random/medical/pillbottle,
/turf/simulated/floor/tiled/airless,
/area/submap/outpost21/structure_generic)
"hQ" = (
/obj/machinery/portable_atmospherics/canister/empty,
/turf/simulated/floor/airless,
/area/submap/outpost21/structure_generic)
"id" = (
/obj/machinery/floodlight,
/turf/simulated/floor/airless,
/area/submap/outpost21/structure_generic)
"ie" = (
/obj/random/maintenance,
/obj/random/maintenance,
/turf/simulated/floor/airless,
/area/submap/outpost21/structure_generic)
"iv" = (
/obj/structure/closet/secure_closet/medical2,
/turf/simulated/floor/tiled/airless,
/area/submap/outpost21/structure_generic)
"iR" = (
/obj/effect/floor_decal/corner/blue,
/turf/simulated/floor/tiled/airless,
/area/submap/outpost21/structure_generic)
"iV" = (
/obj/machinery/door/airlock/maintenance/medical,
/obj/machinery/door/firedoor/border_only,
/turf/simulated/floor,
/area/submap/outpost21/structure_generic)
"kl" = (
/obj/machinery/atmospherics/pipe/simple/hidden/supply{
	dir = 4
	},
/obj/machinery/atmospherics/pipe/simple/hidden/scrubbers{
	dir = 4
	},
/turf/simulated/floor/airless,
/area/submap/outpost21/structure_generic)
"kv" = (
/obj/effect/floor_decal/corner/blue{
	dir = 10
	},
/obj/random/maintenance,
/turf/simulated/floor/tiled/airless,
/area/submap/outpost21/structure_generic)
"kA" = (
/obj/random/maintenance,
/turf/template_noop,
/area/submap/outpost21/structure_generic)
"kR" = (
/obj/effect/floor_decal/corner/blue{
	dir = 4
	},
/obj/random/firstaid,
/turf/simulated/floor/tiled/airless,
/area/submap/outpost21/structure_generic)
"le" = (
/obj/effect/floor_decal/corner/blue{
	dir = 5
	},
/obj/machinery/atmospherics/pipe/simple/hidden/supply{
	dir = 4
	},
/obj/machinery/atmospherics/pipe/simple/hidden/scrubbers{
	dir = 4
	},
/turf/simulated/floor/tiled/airless,
/area/submap/outpost21/structure_generic)
"lp" = (
/obj/structure/lattice,
/turf/template_noop,
/area/submap/outpost21/structure_generic)
"lG" = (
/obj/machinery/atmospherics/portables_connector{
	dir = 1
	},
/obj/effect/floor_decal/industrial/hatch/yellow,
/turf/simulated/floor/tiled/airless,
/area/submap/outpost21/structure_generic)
"mp" = (
/obj/effect/floor_decal/corner/blue{
	dir = 10
	},
/obj/structure/disposalpipe/segment{
	dir = 4
	},
/turf/simulated/floor/tiled/airless,
/area/submap/outpost21/structure_generic)
"mx" = (
/obj/machinery/door/airlock/silver{
	name = "Toilet"
	},
/turf/simulated/floor/tiled/white/airless,
/area/submap/outpost21/structure_generic)
"mI" = (
/obj/machinery/atmospherics/pipe/simple/hidden/supply{
	dir = 4
	},
/obj/machinery/atmospherics/pipe/simple/hidden/scrubbers{
	dir = 4
	},
/obj/structure/disposalpipe/segment{
	dir = 4
	},
/turf/simulated/floor/airless,
/area/submap/outpost21/structure_generic)
"mP" = (
/obj/machinery/atmospherics/unary/freezer{
	icon_state = "freezer"
	},
/obj/effect/floor_decal/industrial/hatch/yellow,
/turf/simulated/floor/tiled/airless,
/area/submap/outpost21/structure_generic)
"nv" = (
/obj/effect/floor_decal/corner/blue{
	dir = 5
	},
/obj/machinery/alarm{
	pixel_y = 26
	},
/obj/machinery/atmospherics/pipe/simple/hidden/supply{
	dir = 4
	},
/obj/machinery/atmospherics/pipe/simple/hidden/scrubbers{
	dir = 4
	},
/turf/simulated/floor/tiled/airless,
/area/submap/outpost21/structure_generic)
"nC" = (
/obj/effect/floor_decal/corner/blue{
	dir = 10
	},
/obj/machinery/atmospherics/unary/vent_pump/on{
	dir = 1
	},
/obj/structure/disposalpipe/segment{
	dir = 4
	},
/turf/simulated/floor/tiled/airless,
/area/submap/outpost21/structure_generic)
"nJ" = (
/obj/effect/floor_decal/corner/blue{
	dir = 10
	},
/obj/random/unidentified_medicine,
/turf/simulated/floor/tiled/airless,
/area/submap/outpost21/structure_generic)
"ob" = (
/obj/effect/floor_decal/corner/blue{
	dir = 6
	},
/obj/machinery/atmospherics/pipe/simple/hidden/scrubbers,
/obj/machinery/atmospherics/pipe/simple/hidden/supply,
/obj/structure/disposalpipe/segment,
/turf/simulated/floor/tiled/airless,
/area/submap/outpost21/structure_generic)
"oN" = (
/obj/structure/toilet{
	dir = 8
	},
/turf/simulated/floor/tiled/white/airless,
/area/submap/outpost21/structure_generic)
"pb" = (
/obj/effect/floor_decal/corner/blue{
	dir = 6
	},
/obj/machinery/atmospherics/pipe/simple/hidden/scrubbers,
/obj/machinery/atmospherics/pipe/simple/hidden/supply,
/obj/structure/disposalpipe/segment,
/obj/random/medical/pillbottle,
/turf/simulated/floor/tiled/airless,
/area/submap/outpost21/structure_generic)
"pe" = (
/obj/effect/floor_decal/corner/blue{
	dir = 10
	},
/obj/machinery/light,
/obj/structure/disposalpipe/segment{
	dir = 4
	},
/turf/simulated/floor/tiled/airless,
/area/submap/outpost21/structure_generic)
"pN" = (
/obj/random/multiple/gun,
/turf/simulated/floor/airless,
/area/submap/outpost21/structure_generic)
"qr" = (
/obj/structure/lattice,
/obj/machinery/alarm{
	pixel_y = 26
	},
/turf/space,
/area/submap/outpost21/structure_generic)
"qs" = (
/obj/machinery/disposal,
/obj/structure/disposalpipe/trunk{
	dir = 4
	},
/turf/simulated/floor/tiled/airless,
/area/submap/outpost21/structure_generic)
"qI" = (
/obj/machinery/light{
	dir = 8
	},
/turf/simulated/floor/tiled/airless,
/area/submap/outpost21/structure_generic)
"rv" = (
/obj/random/unidentified_medicine,
/turf/simulated/floor/tiled/airless,
/area/submap/outpost21/structure_generic)
"sH" = (
/obj/effect/floor_decal/corner/blue{
	dir = 9
	},
/obj/machinery/light{
	dir = 8
	},
/turf/simulated/floor/tiled/airless,
/area/submap/outpost21/structure_generic)
"tc" = (
/obj/machinery/atmospherics/pipe/simple/hidden/scrubbers,
/obj/random/medical/pillbottle,
/turf/simulated/floor/airless,
/area/submap/outpost21/structure_generic)
"tm" = (
/obj/effect/floor_decal/corner/blue{
	dir = 5
	},
/obj/machinery/atmospherics/pipe/manifold/hidden/supply,
/obj/machinery/atmospherics/pipe/manifold/hidden/scrubbers,
/obj/structure/disposalpipe/segment{
	dir = 4
	},
/turf/simulated/floor/tiled/airless,
/area/submap/outpost21/structure_generic)
"to" = (
/obj/machinery/atmospherics/pipe/simple/hidden/supply{
	dir = 4
	},
/obj/machinery/atmospherics/pipe/simple/hidden/scrubbers{
	dir = 9
	},
/turf/simulated/floor/tiled/white/airless,
/area/submap/outpost21/structure_generic)
"tD" = (
/obj/machinery/alarm{
	pixel_y = 26
	},
/turf/simulated/floor/tiled/white/airless,
/area/submap/outpost21/structure_generic)
"tE" = (
/obj/item/broken_device/random,
/turf/simulated/floor/tiled/airless,
/area/submap/outpost21/structure_generic)
"tS" = (
/obj/machinery/atmospherics/pipe/simple/hidden/supply{
	dir = 6
	},
/obj/machinery/atmospherics/pipe/simple/hidden/scrubbers{
	dir = 5
	},
/turf/simulated/floor/tiled/airless,
/area/submap/outpost21/structure_generic)
"ul" = (
/obj/effect/floor_decal/corner/blue{
	dir = 8
	},
/obj/item/broken_device/random,
/turf/simulated/floor/tiled/airless,
/area/submap/outpost21/structure_generic)
"uD" = (
/obj/machinery/light{
	dir = 8
	},
/turf/simulated/floor/airless,
/area/submap/outpost21/structure_generic)
"uG" = (
/obj/item/towel/random,
/turf/simulated/floor/tiled/airless,
/area/submap/outpost21/structure_generic)
"uI" = (
/obj/effect/floor_decal/corner/blue{
	dir = 5
	},
/obj/machinery/light{
	dir = 1
	},
/obj/machinery/atmospherics/pipe/simple/hidden/supply{
	dir = 4
	},
/obj/machinery/atmospherics/pipe/simple/hidden/scrubbers{
	dir = 4
	},
/obj/structure/disposalpipe/segment{
	dir = 4
	},
/turf/simulated/floor/tiled/airless,
/area/submap/outpost21/structure_generic)
"uJ" = (
/obj/machinery/atmospherics/pipe/simple/hidden/supply{
	dir = 4
	},
/obj/machinery/atmospherics/pipe/simple/hidden/scrubbers{
	dir = 4
	},
/obj/structure/disposalpipe/segment{
	dir = 2;
	icon_state = "pipe-c"
	},
/turf/simulated/floor/tiled/white/airless,
/area/submap/outpost21/structure_generic)
"uK" = (
/obj/effect/floor_decal/corner/blue{
	dir = 5
	},
/obj/machinery/atmospherics/pipe/manifold/hidden/scrubbers{
	dir = 1
	},
/obj/machinery/atmospherics/pipe/manifold/hidden/supply{
	dir = 1
	},
/obj/structure/disposalpipe/segment{
	dir = 2;
	icon_state = "pipe-c"
	},
/turf/simulated/floor/tiled/airless,
/area/submap/outpost21/structure_generic)
"uO" = (
/obj/machinery/atmospherics/unary/vent_scrubber/on,
/turf/simulated/floor/tiled/airless,
/area/submap/outpost21/structure_generic)
"vf" = (
/obj/machinery/atmospherics/pipe/simple/hidden/scrubbers{
	dir = 4
	},
/obj/random/multiple/gun,
/turf/simulated/floor/airless,
/area/submap/outpost21/structure_generic)
"vG" = (
/obj/item/flame/lighter/random,
/turf/simulated/floor/airless,
/area/submap/outpost21/structure_generic)
"wc" = (
/obj/machinery/door/airlock/glass_medical,
/obj/machinery/atmospherics/pipe/simple/hidden/scrubbers,
/obj/machinery/atmospherics/pipe/simple/hidden/supply,
/obj/structure/disposalpipe/segment,
/obj/machinery/door/firedoor/border_only,
/turf/simulated/floor/tiled/airless,
/area/submap/outpost21/structure_generic)
"wh" = (
/obj/effect/floor_decal/corner/blue{
	dir = 10
	},
/obj/structure/table/glass,
/obj/structure/disposalpipe/segment{
	dir = 4
	},
/obj/random/firstaid,
/obj/random/firstaid,
/obj/random/firstaid,
/turf/simulated/floor/tiled/airless,
/area/submap/outpost21/structure_generic)
"ww" = (
/obj/effect/floor_decal/corner/blue{
	dir = 10
	},
/obj/item/defib_kit/loaded,
/obj/structure/disposalpipe/segment{
	dir = 4
	},
/turf/simulated/floor/tiled/airless,
/area/submap/outpost21/structure_generic)
"wE" = (
/obj/effect/floor_decal/corner/blue{
	dir = 9
	},
/obj/machinery/light{
	dir = 8
	},
/obj/random/unidentified_medicine,
/turf/simulated/floor/tiled/airless,
/area/submap/outpost21/structure_generic)
"xs" = (
/obj/machinery/portable_atmospherics/canister/nitrous_oxide,
/turf/space,
/area/submap/outpost21/structure_generic)
"xJ" = (
/turf/space,
/area/submap/outpost21/structure_generic)
"ye" = (
/turf/simulated/mineral/vacuum,
/area/submap/outpost21/structure_generic)
"yn" = (
/obj/effect/floor_decal/corner/blue{
	dir = 5
	},
/obj/machinery/atmospherics/pipe/simple/hidden/supply{
	dir = 4
	},
/obj/machinery/atmospherics/pipe/simple/hidden/scrubbers{
	dir = 4
	},
/obj/structure/disposalpipe/junction{
	dir = 4;
	icon_state = "pipe-j2"
	},
/turf/simulated/floor/tiled/airless,
/area/submap/outpost21/structure_generic)
"yM" = (
/obj/structure/medical_stand,
/obj/machinery/atmospherics/pipe/manifold/hidden/scrubbers{
	dir = 1
	},
/obj/machinery/atmospherics/pipe/manifold/hidden/supply{
	dir = 1
	},
/turf/simulated/floor/tiled/airless,
/area/submap/outpost21/structure_generic)
"zb" = (
/obj/effect/floor_decal/corner/blue{
	dir = 5
	},
/obj/machinery/atmospherics/pipe/simple/hidden/supply{
	dir = 4
	},
/obj/machinery/atmospherics/pipe/simple/hidden/scrubbers{
	dir = 4
	},
/obj/structure/disposalpipe/segment{
	dir = 4
	},
/turf/simulated/floor/tiled/airless,
/area/submap/outpost21/structure_generic)
"zz" = (
/obj/random/firstaid,
/turf/simulated/floor/tiled/airless,
/area/submap/outpost21/structure_generic)
"Ac" = (
/obj/machinery/atmospherics/pipe/simple/hidden/supply{
	dir = 4
	},
/obj/machinery/atmospherics/pipe/simple/hidden/scrubbers{
	dir = 4
	},
/obj/structure/disposalpipe/segment{
	dir = 4
	},
/turf/simulated/floor/tiled/airless,
/area/submap/outpost21/structure_generic)
"An" = (
/obj/random/maintenance,
/turf/simulated/floor/airless,
/area/submap/outpost21/structure_generic)
"AB" = (
/obj/random/toolbox,
/turf/simulated/floor/airless,
/area/submap/outpost21/structure_generic)
"BN" = (
/turf/simulated/floor/airless,
/area/submap/outpost21/structure_generic)
"Cw" = (
/obj/machinery/door/airlock/maintenance/medical,
/turf/simulated/floor,
/area/submap/outpost21/structure_generic)
"CL" = (
/turf/template_noop,
/area/submap/outpost21/structure_generic)
"CV" = (
/obj/structure/disposalpipe/segment{
	dir = 4
	},
/turf/simulated/floor/airless,
/area/submap/outpost21/structure_generic)
"Ea" = (
/obj/machinery/atmospherics/unary/cryo_cell{
	layer = 3.3
	},
/turf/simulated/floor,
/area/submap/outpost21/structure_generic)
"Eg" = (
/obj/effect/floor_decal/corner/blue{
	dir = 5
	},
/obj/machinery/alarm{
	pixel_y = 26
	},
/obj/machinery/atmospherics/pipe/simple/hidden/supply{
	dir = 4
	},
/obj/machinery/atmospherics/pipe/simple/hidden/scrubbers{
	dir = 4
	},
/obj/structure/disposalpipe/segment{
	dir = 4
	},
/turf/simulated/floor/tiled/airless,
/area/submap/outpost21/structure_generic)
"Eq" = (
/obj/machinery/atmospherics/pipe/manifold/hidden/scrubbers{
	dir = 8
	},
/obj/machinery/atmospherics/pipe/manifold/hidden/supply{
	dir = 8
	},
/obj/structure/disposalpipe/junction{
	dir = 2;
	icon_state = "pipe-j2"
	},
/turf/simulated/floor/tiled/airless,
/area/submap/outpost21/structure_generic)
"FJ" = (
/obj/effect/floor_decal/corner/blue{
	dir = 6
	},
/obj/item/reagent_containers/glass/beaker/vial/random,
/turf/simulated/floor/tiled/airless,
/area/submap/outpost21/structure_generic)
"FM" = (
/obj/machinery/light{
	dir = 8
	},
/obj/structure/table/glass,
/obj/structure/disposalpipe/segment{
	dir = 1;
	icon_state = "pipe-c"
	},
/turf/simulated/floor/tiled/white/airless,
/area/submap/outpost21/structure_generic)
"FP" = (
/obj/effect/floor_decal/corner/blue{
	dir = 5
	},
/obj/machinery/vending/medical,
/turf/simulated/floor/tiled/airless,
/area/submap/outpost21/structure_generic)
"Gz" = (
/obj/machinery/disposal,
/obj/structure/disposalpipe/trunk{
	dir = 8
	},
/turf/simulated/floor/tiled/white/airless,
/area/submap/outpost21/structure_generic)
"GH" = (
/obj/effect/floor_decal/corner/blue{
	dir = 9
	},
/obj/structure/closet/secure_closet/medical2,
/turf/simulated/floor/tiled/airless,
/area/submap/outpost21/structure_generic)
"GU" = (
/obj/effect/floor_decal/corner/blue{
	dir = 6
	},
/obj/item/towel/random,
/turf/simulated/floor/tiled/airless,
/area/submap/outpost21/structure_generic)
"HL" = (
/obj/item/reagent_containers/glass/beaker/vial/random,
/turf/simulated/floor/airless,
/area/submap/outpost21/structure_generic)
"Jp" = (
/obj/effect/floor_decal/corner/blue{
	dir = 10
	},
/obj/machinery/light,
/turf/simulated/floor/tiled/airless,
/area/submap/outpost21/structure_generic)
"Km" = (
/obj/effect/floor_decal/corner/blue{
	dir = 9
	},
/obj/machinery/alarm{
	dir = 4;
	pixel_x = -26
	},
/obj/random/maintenance,
/turf/simulated/floor/tiled/airless,
/area/submap/outpost21/structure_generic)
"Le" = (
/obj/effect/floor_decal/corner/blue{
	dir = 10
	},
/obj/machinery/alarm{
	dir = 1;
	pixel_y = -26
	},
/turf/simulated/floor/tiled/airless,
/area/submap/outpost21/structure_generic)
"Ln" = (
/turf/template_noop,
/area/template_noop)
"LE" = (
/obj/structure/lattice,
/obj/machinery/light{
	dir = 1
	},
/turf/space,
/area/submap/outpost21/structure_generic)
"Md" = (
/obj/effect/floor_decal/corner/blue{
	dir = 6
	},
/obj/machinery/portable_atmospherics/canister/oxygen/prechilled,
/turf/simulated/floor/tiled/airless,
/area/submap/outpost21/structure_generic)
"MV" = (
/obj/machinery/atmospherics/pipe/simple/hidden/scrubbers,
/obj/machinery/atmospherics/pipe/simple/hidden/supply,
/obj/structure/disposalpipe/segment,
/obj/random/unidentified_medicine,
/turf/simulated/floor/airless,
/area/submap/outpost21/structure_generic)
"Nh" = (
/obj/machinery/atmospherics/pipe/simple/hidden/supply{
	dir = 4
	},
/obj/machinery/atmospherics/pipe/simple/hidden/scrubbers{
	dir = 4
	},
/turf/simulated/floor/tiled/airless,
/area/submap/outpost21/structure_generic)
"Nv" = (
/obj/machinery/atmospherics/pipe/simple/hidden/scrubbers{
	dir = 4
	},
/obj/machinery/atmospherics/pipe/simple/hidden/supply{
	dir = 4
	},
/turf/simulated/floor/tiled/airless,
/area/submap/outpost21/structure_generic)
"NP" = (
/obj/structure/medical_stand,
/turf/simulated/floor/tiled/airless,
/area/submap/outpost21/structure_generic)
"OM" = (
/obj/machinery/atmospherics/pipe/simple/hidden/supply,
/turf/simulated/floor/airless,
/area/submap/outpost21/structure_generic)
"Px" = (
/obj/machinery/portable_atmospherics/canister/oxygen/prechilled,
/turf/simulated/floor/tiled/airless,
/area/submap/outpost21/structure_generic)
"QR" = (
/obj/item/storage/mre/random,
/turf/simulated/floor/airless,
/area/submap/outpost21/structure_generic)
"Rl" = (
/obj/effect/floor_decal/corner/blue{
	dir = 5
	},
/turf/simulated/floor/tiled/airless,
/area/submap/outpost21/structure_generic)
"RV" = (
/obj/machinery/atmospherics/pipe/simple/hidden{
	dir = 4
	},
/obj/effect/floor_decal/corner/blue{
	dir = 1
	},
/turf/simulated/floor/tiled/airless,
/area/submap/outpost21/structure_generic)
"Sf" = (
/obj/machinery/atmospherics/pipe/simple/hidden/scrubbers{
	dir = 4
	},
/obj/machinery/atmospherics/pipe/simple/hidden/supply{
	dir = 4
	},
/obj/random/medical/pillbottle,
/turf/simulated/floor/tiled/airless,
/area/submap/outpost21/structure_generic)
"Sn" = (
/obj/structure/disposalpipe/segment{
	dir = 2;
	icon_state = "pipe-c"
	},
/turf/simulated/floor/tiled/airless,
/area/submap/outpost21/structure_generic)
"St" = (
/obj/machinery/atmospherics/pipe/simple/hidden/scrubbers{
	dir = 4
	},
/obj/machinery/atmospherics/pipe/simple/hidden/supply{
	dir = 4
	},
/obj/random/unidentified_medicine,
/turf/simulated/floor/tiled/airless,
/area/submap/outpost21/structure_generic)
"SO" = (
/obj/effect/floor_decal/corner/blue{
	dir = 10
	},
/turf/simulated/floor/tiled/airless,
/area/submap/outpost21/structure_generic)
"SP" = (
/turf/simulated/wall,
/area/submap/outpost21/structure_generic)
"Ti" = (
/obj/structure/lattice,
/obj/machinery/light{
	dir = 4
	},
/turf/space,
/area/submap/outpost21/structure_generic)
"Tx" = (
/obj/machinery/light{
	dir = 1
	},
/turf/simulated/floor/tiled/airless,
/area/submap/outpost21/structure_generic)
"TN" = (
/obj/random/contraband,
/turf/simulated/floor/airless,
/area/submap/outpost21/structure_generic)
"Xf" = (
/obj/machinery/door/airlock/glass_medical,
/obj/machinery/atmospherics/pipe/simple/hidden/scrubbers,
/obj/machinery/atmospherics/pipe/simple/hidden/supply,
/turf/simulated/floor/tiled/airless,
/area/submap/outpost21/structure_generic)
"XS" = (
/obj/random/maintenance/medical,
/turf/space,
/area/submap/outpost21/structure_generic)
"Ye" = (
/obj/item/broken_device/random,
/obj/random/toolbox,
/turf/simulated/floor/airless,
/area/submap/outpost21/structure_generic)
"Yh" = (
/obj/effect/floor_decal/corner/blue{
	dir = 6
	},
/turf/simulated/floor/tiled/airless,
/area/submap/outpost21/structure_generic)
"Yl" = (
/obj/random/maintenance,
/turf/space,
/area/submap/outpost21/structure_generic)
"Yz" = (
/obj/effect/floor_decal/corner/blue{
	dir = 5
	},
/obj/structure/table/glass,
/turf/simulated/floor/tiled/airless,
/area/submap/outpost21/structure_generic)
"YE" = (
/obj/machinery/atmospherics/pipe/simple/hidden/supply{
	dir = 10
	},
/obj/machinery/atmospherics/pipe/simple/hidden/scrubbers{
	dir = 9
	},
/turf/simulated/floor/tiled/airless,
/area/submap/outpost21/structure_generic)
"YG" = (
/obj/effect/floor_decal/corner/blue{
	dir = 10
	},
/obj/random/medical/pillbottle,
/turf/simulated/floor/tiled/airless,
/area/submap/outpost21/structure_generic)
"YJ" = (
/obj/machinery/atmospherics/pipe/simple/hidden/supply{
	dir = 4
	},
/obj/structure/disposalpipe/segment{
	dir = 4
	},
/turf/simulated/floor/airless,
/area/submap/outpost21/structure_generic)
"YL" = (
/obj/item/reagent_containers/glass/beaker/vial/random,
/turf/simulated/floor/tiled/airless,
/area/submap/outpost21/structure_generic)
"YU" = (
/obj/machinery/door/airlock/glass_medical,
/turf/simulated/floor/tiled/milspec/sterile,
/area/submap/outpost21/structure_generic)
"YW" = (
/obj/effect/floor_decal/corner/blue{
	dir = 9
	},
/turf/simulated/floor/tiled/airless,
/area/submap/outpost21/structure_generic)
"Zj" = (
/obj/machinery/atmospherics/pipe/simple/hidden/scrubbers,
/obj/machinery/atmospherics/pipe/simple/hidden/supply,
/obj/structure/disposalpipe/segment{
	dir = 4
	},
/turf/simulated/floor/tiled/airless,
/area/submap/outpost21/structure_generic)
"ZX" = (
/obj/structure/lattice,
/turf/space,
/area/submap/outpost21/structure_generic)

(1,1,1) = {"
Ln
Ln
Ln
Ln
Ln
Ln
Ln
Ln
Ln
Ln
Ln
Ln
Ln
Ln
Ln
Ln
Ln
Ln
Ln
Ln
Ln
Ln
Ln
Ln
Ln
Ln
Ln
Ln
Ln
Ln
Ln
Ln
Ln
Ln
Ln
Ln
Ln
Ln
Ln
Ln
"}
(2,1,1) = {"
Ln
CL
CL
CL
CL
CL
CL
CL
CL
CL
CL
CL
CL
CL
CL
CL
CL
CL
CL
CL
CL
CL
CL
CL
CL
CL
CL
CL
CL
CL
CL
CL
CL
CL
CL
CL
CL
CL
CL
Ln
"}
(3,1,1) = {"
Ln
CL
CL
CL
CL
CL
CL
CL
CL
CL
CL
CL
CL
CL
CL
CL
CL
CL
ZX
CL
CL
CL
CL
CL
CL
CL
CL
CL
CL
CL
CL
CL
CL
CL
CL
CL
CL
CL
CL
Ln
"}
(4,1,1) = {"
Ln
CL
CL
CL
CL
CL
CL
CL
CL
CL
CL
CL
CL
CL
CL
CL
ZX
ZX
ZX
CL
CL
CL
CL
CL
CV
CL
ZX
CL
CL
CL
CL
CL
CL
CL
CL
CL
CL
CL
CL
Ln
"}
(5,1,1) = {"
Ln
CL
CL
CL
CL
CL
CL
CL
CL
CL
CL
CL
CL
CL
CL
CL
xJ
ZX
xJ
CL
CL
CL
CL
ZX
YJ
BN
SP
CL
CL
CL
CL
CL
CL
CL
CL
CL
CL
CL
CL
Ln
"}
(6,1,1) = {"
Ln
CL
CL
CL
CL
CL
CL
CL
CL
ZX
CL
ZX
CL
CL
CL
ZX
xJ
xJ
xJ
xJ
xJ
CL
xJ
ZX
mI
xJ
xJ
CL
CL
CL
CL
CL
CL
CL
ye
ZX
CL
CL
CL
Ln
"}
(7,1,1) = {"
Ln
CL
CL
CL
CL
CL
CL
CL
CL
ZX
ye
ye
ye
ye
ZX
ZX
ZX
xJ
XS
xJ
xJ
xJ
xJ
SP
zb
BN
ZX
xJ
xJ
CL
CL
CL
ZX
ye
ye
ye
ZX
CL
CL
Ln
"}
(8,1,1) = {"
Ln
CL
CL
CL
CL
CL
CL
CL
CL
ye
ye
ye
ye
ye
ye
ye
xJ
xJ
xJ
xJ
XS
xJ
ZX
SP
zb
BN
SP
xJ
xJ
xJ
xJ
CL
CL
ZX
ZX
CL
CL
CL
CL
Ln
"}
(9,1,1) = {"
Ln
CL
CL
CL
CL
CL
CL
CL
ZX
ye
ye
ye
ye
ye
ye
ye
ye
ZX
xJ
xJ
xJ
xJ
xJ
SP
Eg
dg
SP
ZX
ZX
xJ
xJ
CL
CL
CL
CL
CL
CL
CL
CL
Ln
"}
(10,1,1) = {"
Ln
CL
CL
CL
CL
CL
CL
CL
ZX
xJ
ye
ye
ye
ye
ye
ZX
ZX
ZX
SP
SP
SP
SP
SP
SP
uI
bo
Cw
xJ
xJ
xJ
xJ
Yl
CL
CL
CL
CL
CL
CL
CL
Ln
"}
(11,1,1) = {"
Ln
CL
CL
CL
CL
CL
ZX
ZX
ZX
ZX
ZX
ye
ye
ye
ye
ye
ZX
xJ
ZX
sH
GH
GH
qs
SP
Ac
SO
SP
ZX
xJ
xJ
xJ
xJ
xJ
xJ
CL
CL
CL
CL
CL
Ln
"}
(12,1,1) = {"
Ln
CL
CL
CL
CL
CL
CL
CL
ZX
xJ
xJ
ZX
xJ
xJ
xJ
BN
ef
iR
Yh
kR
uO
tS
nC
lp
Ac
SO
SP
ZX
ZX
ZX
ZX
ZX
xJ
xJ
Yl
CL
CL
CL
CL
Ln
"}
(13,1,1) = {"
Ln
CL
CL
CL
CL
CL
CL
CL
xJ
xJ
xJ
SP
xJ
BN
BN
pN
BN
SO
mP
hB
lG
Nv
pe
SP
zb
SO
SP
ZX
ye
ye
ye
ye
ye
ZX
xJ
xJ
ZX
ZX
CL
Ln
"}
(14,1,1) = {"
Ln
CL
CL
CL
CL
CL
CL
xJ
xJ
xJ
BN
SP
LE
dg
BN
dg
dg
SO
Ea
fE
Px
Nv
dD
SP
zb
SO
SP
ye
ye
ye
ye
ye
ye
xJ
xJ
xJ
xJ
ZX
CL
Ln
"}
(15,1,1) = {"
Ln
CL
CL
CL
CL
CL
CL
xJ
xJ
XS
xJ
SP
qr
BN
Px
rv
dg
SO
Ea
fE
dg
St
wh
SP
zb
SO
SP
ye
ye
ye
ye
ye
ye
ye
xJ
xJ
xJ
CL
CL
Ln
"}
(16,1,1) = {"
Ln
CL
CL
CL
CL
CL
CL
xJ
xJ
xJ
BN
SP
ZX
BN
Rl
dg
dg
ul
YW
RV
dg
Nv
mp
lp
Ac
kv
SP
ZX
SP
ye
xJ
xJ
ZX
xJ
xJ
xJ
xJ
CL
CL
Ln
"}
(17,1,1) = {"
Ln
CL
CL
CL
ZX
CL
CL
xJ
xJ
BN
hQ
iV
xJ
BN
Rl
dg
dg
iR
Yh
dn
uG
Nv
ww
SP
zb
kv
SP
An
ZX
xJ
xJ
ye
ye
ZX
ZX
xJ
xJ
CL
CL
Ln
"}
(18,1,1) = {"
Ln
CL
CL
CL
ye
ye
CL
xJ
xJ
xJ
hQ
SP
xJ
BN
FP
NP
dg
nJ
Ea
fE
dg
Sf
pe
SP
uI
SO
SP
id
TN
SP
SP
SP
SP
ZX
xJ
xJ
xJ
xJ
CL
Ln
"}
(19,1,1) = {"
Ln
CL
CL
ye
ye
ye
ZX
XS
xJ
xJ
xJ
SP
xJ
BN
Yz
dg
zz
SO
Ea
fE
tE
yM
Zj
Xf
tm
SO
SP
id
Ye
vG
ie
An
SP
ZX
xJ
xJ
xJ
xJ
CL
Ln
"}
(20,1,1) = {"
Ln
CL
ZX
ye
ye
ZX
CL
xJ
xJ
xJ
xJ
xJ
xJ
BN
Yz
ef
dg
SO
aX
ge
dg
Nv
Sn
cA
yn
SO
SP
SP
SP
SP
SP
iV
SP
SP
SP
ZX
SP
xJ
CL
Ln
"}
(21,1,1) = {"
Ln
CL
CL
CL
CL
CL
CL
xJ
xJ
XS
xJ
SP
xJ
xJ
BN
BN
fy
BN
BN
bA
uO
YE
er
SP
zb
dg
hc
YW
wE
Km
YW
YW
YW
YW
qI
BN
YW
BN
CL
Ln
"}
(22,1,1) = {"
Ln
CL
CL
CL
CL
CL
CL
xJ
xJ
xJ
BN
SP
LE
ZX
ZX
xJ
BN
ZX
BN
dg
dg
dg
Le
SP
uK
fI
wc
ob
pb
ob
fI
Eq
ob
MV
OM
xJ
xJ
xJ
CL
Ln
"}
(23,1,1) = {"
Ln
CL
CL
CL
CL
CL
CL
CL
xJ
xJ
xJ
SP
BN
BN
BN
xs
xJ
xJ
Ti
Md
rv
GU
iv
SP
le
dg
SP
SP
SP
SP
lp
fp
SP
SP
ZX
ZX
ZX
xJ
CL
Ln
"}
(24,1,1) = {"
Ln
CL
CL
CL
CL
CL
CL
CL
ye
ye
ye
ye
ye
ye
ye
xJ
xs
SP
SP
SP
YU
SP
SP
SP
nv
SO
SP
tD
bS
BN
bS
uJ
FM
ZX
xJ
xJ
xJ
CL
CL
Ln
"}
(25,1,1) = {"
Ln
CL
CL
CL
CL
CL
CL
ZX
ye
ye
ye
ye
ye
ye
ye
ye
ZX
xJ
BN
fh
dg
uD
QR
SP
le
SO
SP
gD
tc
BN
BN
to
Gz
ZX
xJ
CL
CL
CL
CL
Ln
"}
(26,1,1) = {"
Ln
CL
CL
CL
CL
CL
CL
ZX
ZX
ye
ye
ye
ye
ye
ye
ye
ZX
xJ
AB
dg
dg
dg
ZX
SP
le
Jp
SP
mx
SP
An
SP
bS
BN
xJ
CL
CL
CL
CL
CL
Ln
"}
(27,1,1) = {"
Ln
CL
CL
CL
CL
CL
CL
CL
xJ
ye
ye
ye
ye
ye
ye
ye
ZX
xJ
BN
BN
YL
BN
ZX
SP
le
YG
SP
oN
SP
oN
SP
BN
xJ
CL
CL
CL
CL
CL
CL
Ln
"}
(28,1,1) = {"
Ln
CL
CL
CL
CL
CL
CL
CL
CL
xJ
ye
ye
ye
ye
ye
ye
ZX
ZX
xJ
BN
dg
HL
xJ
xJ
Nh
SO
SP
SP
SP
SP
SP
xJ
xJ
CL
CL
CL
CL
CL
CL
Ln
"}
(29,1,1) = {"
Ln
CL
CL
CL
CL
CL
CL
CL
ZX
ZX
ZX
ZX
ye
ye
ye
xJ
xJ
xJ
xJ
FJ
FJ
Yh
BN
SP
kl
dg
SP
xJ
xJ
xJ
xJ
CL
CL
CL
CL
CL
CL
CL
CL
Ln
"}
(30,1,1) = {"
Ln
CL
CL
CL
CL
CL
CL
CL
CL
xJ
xJ
xJ
xJ
xJ
xJ
SP
SP
SP
SP
SP
SP
SP
SP
SP
vf
dg
SP
xJ
xJ
xJ
CL
CL
CL
CL
CL
CL
CL
CL
CL
Ln
"}
(31,1,1) = {"
Ln
CL
CL
CL
CL
CL
CL
CL
CL
xJ
xJ
xJ
xJ
xJ
xJ
xJ
xJ
xJ
xJ
xJ
xJ
ZX
ZX
xJ
ZX
BN
ZX
xJ
CL
CL
CL
CL
CL
CL
CL
CL
CL
CL
CL
Ln
"}
(32,1,1) = {"
Ln
CL
CL
CL
CL
CL
CL
CL
CL
CL
xJ
xJ
xJ
xJ
SP
xJ
xJ
xJ
xJ
xJ
xJ
xJ
xJ
SP
dg
BN
ZX
CL
CL
CL
CL
CL
CL
CL
CL
ZX
CL
CL
CL
Ln
"}
(33,1,1) = {"
Ln
CL
CL
CL
CL
CL
CL
CL
CL
CL
xJ
ZX
SP
xJ
xJ
xJ
xJ
xJ
xJ
xs
xJ
xJ
xJ
SP
Tx
BN
ZX
CL
CL
CL
CL
CL
CL
CL
CL
ye
ye
CL
CL
Ln
"}
(34,1,1) = {"
Ln
CL
CL
CL
CL
CL
CL
CL
CL
CL
CL
ZX
SP
CL
CL
CL
Yl
xJ
CL
CL
CL
CL
xJ
SP
BN
xJ
xJ
CL
CL
CL
CL
CL
CL
CL
ye
ye
ye
ye
CL
Ln
"}
(35,1,1) = {"
Ln
CL
CL
CL
CL
CL
CL
CL
CL
CL
CL
ZX
ZX
CL
CL
CL
CL
CL
CL
CL
CL
CL
xJ
ZX
xJ
xJ
CL
CL
CL
CL
CL
kA
CL
ZX
ye
ye
ye
ye
CL
Ln
"}
(36,1,1) = {"
Ln
CL
CL
CL
CL
CL
CL
CL
CL
CL
CL
ZX
CL
CL
CL
CL
CL
CL
CL
CL
CL
CL
ZX
ZX
ZX
ZX
CL
CL
CL
ZX
CL
CL
CL
CL
ZX
ZX
CL
CL
CL
Ln
"}
(37,1,1) = {"
Ln
CL
CL
CL
CL
CL
CL
CL
CL
CL
CL
ZX
CL
CL
CL
CL
CL
CL
CL
CL
CL
CL
CL
CL
ZX
CL
CL
CL
CL
ZX
CL
CL
CL
CL
CL
CL
CL
CL
CL
Ln
"}
(38,1,1) = {"
Ln
CL
CL
CL
CL
CL
CL
CL
CL
CL
CL
CL
CL
CL
CL
CL
CL
CL
CL
CL
CL
CL
CL
CL
ZX
CL
CL
CL
CL
CL
CL
CL
CL
CL
CL
CL
CL
CL
CL
Ln
"}
(39,1,1) = {"
Ln
CL
CL
CL
CL
CL
CL
CL
CL
CL
CL
CL
CL
CL
CL
CL
CL
CL
CL
CL
CL
CL
CL
CL
CL
CL
CL
CL
CL
CL
CL
CL
CL
CL
CL
CL
CL
CL
CL
Ln
"}
(40,1,1) = {"
Ln
Ln
Ln
Ln
Ln
Ln
Ln
Ln
Ln
Ln
Ln
Ln
Ln
Ln
Ln
Ln
Ln
Ln
Ln
Ln
Ln
Ln
Ln
Ln
Ln
Ln
Ln
Ln
Ln
Ln
Ln
Ln
Ln
Ln
Ln
Ln
Ln
Ln
Ln
Ln
"}
