//MAP CONVERTED BY dmm2tgm.py THIS HEADER COMMENT PREVENTS RECONVERSION, DO NOT REMOVE
"a" = (
/turf/simulated/floor/tiled/dark/turfpack/muriki,
/area/rnd/xenobiology/lost)
"b" = (
/obj/item/material/shard/shrapnel,
/turf/simulated/floor/plating/turfpack/muriki,
/area/rnd/xenobiology/lost)
"d" = (
/obj/effect/landmark/loot_spawn/low,
/turf/simulated/floor/plating/turfpack/muriki,
/area/rnd/xenobiology/lost)
"e" = (
/turf/template_noop,
/area/template_noop)
"f" = (
/obj/machinery/door/window,
/turf/simulated/floor/plating/turfpack/muriki,
/area/rnd/xenobiology/lost)
"g" = (
/mob/living/simple_mob/animal/space/carp/puffer,
/turf/simulated/floor/plating/turfpack/muriki,
/area/rnd/xenobiology/lost)
"i" = (
/obj/structure/cable/green{
	icon_state = "4-8"
	},
/turf/simulated/floor/tiled/dark/turfpack/muriki,
/area/rnd/xenobiology/lost)
"j" = (
/obj/effect/landmark/dangerous_situation,
/turf/simulated/floor/plating/turfpack/muriki,
/area/rnd/xenobiology/lost)
"k" = (
/obj/machinery/disposal,
/turf/simulated/floor/tiled/dark/turfpack/muriki,
/area/rnd/xenobiology/lost)
"l" = (
/obj/structure/window/basic{
	dir = 4
	},
/obj/structure/window/basic,
/obj/structure/grille/broken,
/obj/item/material/shard/shrapnel,
/obj/item/material/shard/shrapnel,
/turf/simulated/floor/plating/turfpack/muriki,
/area/rnd/xenobiology/lost)
"m" = (
/obj/structure/window/basic{
	dir = 8
	},
/obj/structure/window/basic{
	dir = 4
	},
/obj/structure/window/basic{
	dir = 1
	},
/obj/structure/window/basic,
/obj/structure/grille,
/turf/simulated/floor/plating/turfpack/muriki,
/area/rnd/xenobiology/lost)
"n" = (
/obj/effect/landmark/step_trap,
/turf/simulated/floor/plating/turfpack/muriki,
/area/rnd/xenobiology/lost)
"o" = (
/obj/effect/landmark/loot_spawn,
/turf/simulated/floor/plating/turfpack/muriki,
/area/rnd/xenobiology/lost)
"q" = (
/obj/effect/landmark/hostile_xenobio,
/turf/simulated/floor/tiled/dark/turfpack/muriki,
/area/rnd/xenobiology/lost)
"r" = (
/mob/living/simple_mob/animal/space/carp,
/turf/simulated/floor/plating/turfpack/muriki,
/area/rnd/xenobiology/lost)
"s" = (
/obj/structure/window/basic{
	dir = 4
	},
/obj/structure/window/basic{
	dir = 1
	},
/obj/item/material/shard/shrapnel,
/obj/item/material/shard/shrapnel,
/obj/item/material/shard/shrapnel,
/obj/item/material/shard/shrapnel,
/turf/simulated/floor/plating/turfpack/muriki,
/area/rnd/xenobiology/lost)
"t" = (
/obj/structure/window/basic{
	dir = 8
	},
/obj/structure/window/basic{
	dir = 4
	},
/obj/structure/window/basic,
/obj/structure/window/basic{
	dir = 1
	},
/obj/structure/grille,
/turf/simulated/floor/plating/turfpack/muriki,
/area/rnd/xenobiology/lost)
"u" = (
/obj/effect/landmark/event_spawn/maintpred,
/turf/simulated/floor/tiled/dark/turfpack/muriki,
/area/rnd/xenobiology/lost)
"v" = (
/obj/structure/window/basic{
	dir = 4
	},
/obj/structure/window/basic{
	dir = 1
	},
/obj/structure/window/basic,
/obj/structure/grille,
/obj/item/material/shard/shrapnel,
/obj/item/material/shard/shrapnel,
/turf/simulated/floor/plating/turfpack/muriki,
/area/rnd/xenobiology/lost)
"w" = (
/obj/structure/barricade,
/turf/simulated/floor/plating/turfpack/muriki,
/area/rnd/xenobiology/lost)
"x" = (
/turf/simulated/floor/plating/turfpack/muriki,
/area/rnd/xenobiology/lost)
"y" = (
/obj/structure/cable/green{
	icon_state = "1-8"
	},
/turf/simulated/floor/tiled/dark/turfpack/muriki,
/area/rnd/xenobiology/lost)
"z" = (
/obj/structure/disposaloutlet,
/turf/simulated/floor/plating/turfpack/muriki,
/area/rnd/xenobiology/lost)
"B" = (
/turf/simulated/wall/r_wall,
/area/rnd/xenobiology/lost)
"C" = (
/obj/item/beartrap{
	anchored = 1;
	deployed = 1
	},
/turf/simulated/floor/tiled/dark/turfpack/muriki,
/area/rnd/xenobiology/lost)
"D" = (
/obj/item/material/shard/shrapnel,
/obj/item/material/shard/shrapnel,
/turf/simulated/floor/plating/turfpack/muriki,
/area/rnd/xenobiology/lost)
"F" = (
/obj/structure/window/basic{
	dir = 4
	},
/obj/structure/window/basic{
	dir = 1
	},
/obj/structure/grille,
/obj/item/material/shard/shrapnel,
/obj/item/material/shard/shrapnel,
/obj/item/material/shard/shrapnel,
/obj/item/material/shard/shrapnel,
/turf/simulated/floor/plating/turfpack/muriki,
/area/rnd/xenobiology/lost)
"G" = (
/obj/machinery/power/apc/alarms_hidden{
	dir = 1;
	pixel_y = 30
	},
/obj/structure/cable/green{
	icon_state = "0-2"
	},
/turf/simulated/floor/tiled/dark/turfpack/muriki,
/area/rnd/xenobiology/lost)
"H" = (
/obj/structure/closet/crate/mimic/cointoss,
/obj/effect/landmark/loot_spawn/low,
/turf/simulated/floor/tiled/dark/turfpack/muriki,
/area/rnd/xenobiology/lost)
"I" = (
/mob/living/simple_mob/animal/space/carp/large,
/turf/simulated/floor/plating/turfpack/muriki,
/area/rnd/xenobiology/lost)
"J" = (
/obj/structure/cable/green{
	icon_state = "4-8"
	},
/turf/simulated/floor/plating/turfpack/muriki,
/area/rnd/xenobiology/lost)
"K" = (
/obj/effect/landmark/hostile_xenobio,
/turf/simulated/floor/plating/turfpack/muriki,
/area/rnd/xenobiology/lost)
"L" = (
/obj/structure/window/basic{
	dir = 8
	},
/obj/structure/window/basic{
	dir = 4
	},
/obj/structure/window/basic,
/obj/structure/grille,
/turf/simulated/floor/plating/turfpack/muriki,
/area/rnd/xenobiology/lost)
"M" = (
/obj/effect/landmark/dangerous_situation,
/turf/simulated/floor/tiled/dark/turfpack/muriki,
/area/rnd/xenobiology/lost)
"O" = (
/obj/effect/landmark/step_trap,
/turf/simulated/floor/tiled/dark/turfpack/muriki,
/area/rnd/xenobiology/lost)
"P" = (
/obj/random/cutout,
/turf/simulated/floor/plating/turfpack/muriki,
/area/rnd/xenobiology/lost)
"R" = (
/mob/living/simple_mob/animal/space/carp/large/huge,
/turf/simulated/floor/plating/turfpack/muriki,
/area/rnd/xenobiology/lost)
"S" = (
/obj/structure/foamedmetal,
/turf/template_noop,
/area/rnd/xenobiology/lost)
"U" = (
/turf/template_noop,
/area/rnd/xenobiology/lost)
"W" = (
/obj/structure/disposaloutlet{
	dir = 1
	},
/turf/simulated/floor/plating/turfpack/muriki,
/area/rnd/xenobiology/lost)
"X" = (
/obj/item/material/shard/shrapnel,
/turf/simulated/floor/tiled/dark/turfpack/muriki,
/area/rnd/xenobiology/lost)
"Z" = (
/obj/structure/barricade,
/turf/simulated/floor/tiled/dark/turfpack/muriki,
/area/rnd/xenobiology/lost)

(1,1,1) = {"
e
e
e
e
e
e
e
e
B
Z
Z
B
e
e
e
e
e
e
e
e
"}
(2,1,1) = {"
B
B
B
B
B
B
B
B
B
C
C
B
B
B
B
B
B
B
B
B
"}
(3,1,1) = {"
B
r
d
x
B
z
I
x
B
a
O
B
K
x
W
B
z
P
x
B
"}
(4,1,1) = {"
B
x
I
x
B
o
x
I
B
a
a
B
x
K
x
B
K
x
x
B
"}
(5,1,1) = {"
B
g
x
x
B
x
R
x
B
a
P
B
x
x
x
B
x
b
K
B
"}
(6,1,1) = {"
B
F
f
t
B
v
f
L
B
a
a
B
t
f
s
B
m
D
l
B
"}
(7,1,1) = {"
S
S
S
a
a
k
a
a
B
a
a
B
a
a
k
a
k
X
a
B
"}
(8,1,1) = {"
S
S
S
a
a
a
a
a
Z
u
x
Z
a
a
a
a
a
a
a
B
"}
(9,1,1) = {"
S
S
S
j
a
a
a
a
w
a
J
a
a
a
a
a
x
a
x
B
"}
(10,1,1) = {"
B
S
a
a
a
a
n
a
a
M
i
C
a
K
a
a
a
q
S
B
"}
(11,1,1) = {"
B
a
x
a
a
a
a
a
B
G
y
B
a
a
a
a
a
S
S
B
"}
(12,1,1) = {"
B
B
U
a
k
a
a
a
B
k
H
B
a
a
x
S
S
S
S
B
"}
(13,1,1) = {"
e
B
B
B
B
B
B
B
B
B
B
B
B
B
B
B
S
S
S
e
"}
