//MAP CONVERTED BY dmm2tgm.py THIS HEADER COMMENT PREVENTS RECONVERSION, DO NOT REMOVE
"a" = (
/turf/simulated/wall,
/area/space)
"c" = (
/turf/simulated/mineral/alt/turfpack/muriki,
/area/space)
"d" = (
/obj/structure/target_stake,
/obj/item/target/alien,
/turf/simulated/floor/plating/turfpack/muriki,
/area/space)
"i" = (
/obj/structure/loot_pile/mecha/marauder,
/turf/simulated/floor/tiled/turfpack/muriki,
/area/space)
"k" = (
/mob/living/simple_mob/vore/aggressive/corrupthound/prettyboi,
/turf/simulated/floor/plating/turfpack/muriki,
/area/space)
"o" = (
/obj/effect/auto_crayon{
	icon_state = "uboa"
	},
/turf/simulated/wall,
/area/space)
"p" = (
/obj/effect/landmark/dangerous_situation,
/turf/simulated/floor/plating/turfpack/muriki,
/area/space)
"s" = (
/obj/structure/table/steel_reinforced,
/turf/simulated/floor/plating/turfpack/muriki,
/area/space)
"u" = (
/obj/structure/table/steel_reinforced,
/turf/simulated/floor/tiled/turfpack/muriki,
/area/space)
"w" = (
/turf/simulated/floor/plating/turfpack/muriki,
/area/space)
"z" = (
/obj/structure/table/steel_reinforced,
/obj/item/gun/launcher/crossbow/bow/hardlight,
/turf/simulated/floor/tiled/turfpack/muriki,
/area/space)
"E" = (
/turf/simulated/mineral/alt/ignore_cavegen,
/area/space)
"G" = (
/obj/structure/target_stake,
/obj/item/target,
/turf/simulated/floor/plating/turfpack/muriki,
/area/space)
"M" = (
/obj/structure/target_stake,
/obj/item/target/syndicate,
/turf/simulated/floor/tiled/turfpack/muriki,
/area/space)
"N" = (
/turf/simulated/floor/tiled/turfpack/muriki,
/area/space)

(1,1,1) = {"
E
E
E
a
E
a
E
"}
(2,1,1) = {"
E
E
E
i
w
k
o
"}
(3,1,1) = {"
E
N
N
w
w
w
N
"}
(4,1,1) = {"
a
N
p
k
w
N
E
"}
(5,1,1) = {"
a
u
u
z
s
s
a
"}
(6,1,1) = {"
a
N
w
w
w
w
a
"}
(7,1,1) = {"
a
w
N
w
w
w
a
"}
(8,1,1) = {"
a
k
N
w
w
w
a
"}
(9,1,1) = {"
a
w
w
w
N
N
a
"}
(10,1,1) = {"
a
G
d
d
M
M
a
"}
(11,1,1) = {"
E
E
w
w
w
c
a
"}
(12,1,1) = {"
E
E
E
E
E
a
a
"}
