//MAP CONVERTED BY dmm2tgm.py THIS HEADER COMMENT PREVENTS RECONVERSION, DO NOT REMOVE
"a" = (
/turf/template_noop,
/area/template_noop)
"i" = (
/obj/machinery/door/airlock/angled_bay/standard/color/cargo{
	dir = 4;
	name = "Cargo Container"
	},
/obj/effect/auto_roof{
	roof_type = /turf/simulated/floor/plating/turfpack/muriki
	},
/turf/simulated/floor/plating,
/area/submap/outpost21/yard_cargocontainer)
"j" = (
/obj/structure/closet/crate,
/obj/random/maintenance,
/obj/random/maintenance,
/obj/random/maintenance,
/obj/random/maintenance,
/obj/random/maintenance,
/obj/random/maintenance,
/obj/random/maintenance,
/obj/random/maintenance,
/obj/effect/auto_roof{
	roof_type = /turf/simulated/floor/plating/turfpack/muriki
	},
/turf/simulated/floor/plating,
/area/submap/outpost21/yard_cargocontainer)
"k" = (
/obj/effect/landmark/vermin,
/obj/effect/auto_roof{
	roof_type = /turf/simulated/floor/plating/turfpack/muriki
	},
/turf/simulated/floor/plating,
/area/submap/outpost21/yard_cargocontainer)
"m" = (
/obj/structure/table/rack/shelf/steel,
/obj/random/maintenance,
/obj/effect/auto_roof{
	roof_type = /turf/simulated/floor/plating/turfpack/muriki
	},
/obj/random/contraband,
/turf/simulated/floor/plating,
/area/submap/outpost21/yard_cargocontainer)
"s" = (
/obj/structure/closet/crate,
/obj/random/maintenance,
/obj/random/maintenance,
/obj/random/maintenance,
/obj/random/maintenance,
/obj/random/maintenance,
/obj/random/maintenance,
/obj/random/maintenance,
/obj/random/junk,
/obj/effect/auto_roof{
	roof_type = /turf/simulated/floor/plating/turfpack/muriki
	},
/obj/random/contraband,
/turf/simulated/floor/plating,
/area/submap/outpost21/yard_cargocontainer)
"z" = (
/obj/random/junk,
/obj/effect/auto_roof{
	roof_type = /turf/simulated/floor/plating/turfpack/muriki
	},
/turf/simulated/floor/plating,
/area/submap/outpost21/yard_cargocontainer)
"L" = (
/obj/effect/auto_roof{
	roof_type = /turf/simulated/floor/plating/turfpack/muriki
	},
/turf/simulated/wall/bay/steel,
/area/submap/outpost21/yard_cargocontainer)
"R" = (
/turf/template_noop,
/area/submap/outpost21/yard_generic)
"T" = (
/obj/structure/table/rack/shelf/steel,
/obj/random/maintenance,
/obj/effect/auto_roof{
	roof_type = /turf/simulated/floor/plating/turfpack/muriki
	},
/turf/simulated/floor/plating,
/area/submap/outpost21/yard_cargocontainer)
"V" = (
/obj/effect/auto_roof{
	roof_type = /turf/simulated/floor/plating/turfpack/muriki
	},
/turf/simulated/floor/plating,
/area/submap/outpost21/yard_cargocontainer)
"W" = (
/obj/structure/table/rack/shelf/steel,
/obj/random/maintenance,
/obj/random/junk,
/obj/effect/auto_roof{
	roof_type = /turf/simulated/floor/plating/turfpack/muriki
	},
/turf/simulated/floor/plating,
/area/submap/outpost21/yard_cargocontainer)

(1,1,1) = {"
a
a
a
a
a
a
a
a
a
"}
(2,1,1) = {"
a
R
L
L
i
L
L
R
a
"}
(3,1,1) = {"
a
R
L
T
V
T
L
R
a
"}
(4,1,1) = {"
a
R
L
W
z
m
L
R
a
"}
(5,1,1) = {"
a
R
L
T
k
W
L
R
a
"}
(6,1,1) = {"
a
R
L
W
V
T
L
R
a
"}
(7,1,1) = {"
a
R
L
j
z
s
L
R
a
"}
(8,1,1) = {"
a
R
L
L
L
L
L
R
a
"}
(9,1,1) = {"
a
a
a
a
a
a
a
a
a
"}
