//MAP CONVERTED BY dmm2tgm.py THIS HEADER COMMENT PREVENTS RECONVERSION, DO NOT REMOVE
"a" = (
/obj/effect/auto_roof{
	roof_type = /turf/simulated/floor/plating/turfpack/muriki
	},
/turf/simulated/wall/bay/steel,
/area/submap/outpost21/yard_cargocontainer)
"d" = (
/obj/structure/closet/crate/miningcar,
/obj/random/material/refined,
/obj/random/material/refined,
/obj/random/material/refined,
/obj/random/material/refined,
/obj/random/material/refined,
/obj/random/material/refined,
/obj/random/material/refined,
/obj/random/material/refined,
/obj/random/material/refined,
/obj/random/material/refined,
/obj/effect/auto_roof{
	roof_type = /turf/simulated/floor/plating/turfpack/muriki
	},
/turf/simulated/floor/plating,
/area/submap/outpost21/yard_cargocontainer)
"g" = (
/turf/template_noop,
/area/template_noop)
"p" = (
/obj/effect/auto_roof{
	roof_type = /turf/simulated/floor/plating/turfpack/muriki
	},
/obj/structure/prop/statue/jumpscare,
/turf/simulated/floor/plating,
/area/submap/outpost21/yard_cargocontainer)
"t" = (
/obj/structure/table/rack/shelf/steel,
/obj/random/maintenance/misc,
/obj/random/maintenance/misc,
/obj/random/maintenance/misc,
/obj/random/maintenance/morestuff,
/obj/effect/auto_roof{
	roof_type = /turf/simulated/floor/plating/turfpack/muriki
	},
/turf/simulated/floor/plating,
/area/submap/outpost21/yard_cargocontainer)
"v" = (
/turf/template_noop,
/area/submap/outpost21/yard_generic)
"y" = (
/obj/structure/closet/crate/chest,
/obj/random/material/precious,
/obj/random/material/precious,
/obj/random/material/precious,
/obj/random/material/precious,
/obj/random/material/precious,
/obj/random/material/precious,
/obj/random/material/precious,
/obj/random/material/precious,
/obj/random/material/precious,
/obj/random/material/precious,
/obj/effect/auto_roof{
	roof_type = /turf/simulated/floor/plating/turfpack/muriki
	},
/turf/simulated/floor/plating,
/area/submap/outpost21/yard_cargocontainer)
"F" = (
/obj/machinery/door/airlock/angled_bay/standard/color/cargo{
	dir = 4;
	name = "Cargo Container"
	},
/obj/effect/auto_roof{
	roof_type = /turf/simulated/floor/plating/turfpack/muriki
	},
/turf/simulated/floor/plating,
/area/submap/outpost21/yard_cargocontainer)
"H" = (
/obj/effect/auto_roof{
	roof_type = /turf/simulated/floor/plating/turfpack/muriki
	},
/turf/simulated/floor/plating,
/area/submap/outpost21/yard_cargocontainer)
"R" = (
/obj/random/cutout,
/obj/effect/auto_roof{
	roof_type = /turf/simulated/floor/plating/turfpack/muriki
	},
/turf/simulated/floor/plating,
/area/submap/outpost21/yard_cargocontainer)

(1,1,1) = {"
g
g
g
g
g
g
g
g
g
"}
(2,1,1) = {"
g
v
a
a
F
a
a
v
g
"}
(3,1,1) = {"
g
v
a
t
H
R
a
v
g
"}
(4,1,1) = {"
g
v
a
t
H
d
a
v
g
"}
(5,1,1) = {"
g
v
a
t
H
R
a
v
g
"}
(6,1,1) = {"
g
v
a
R
H
p
a
v
g
"}
(7,1,1) = {"
g
v
a
y
H
R
a
v
g
"}
(8,1,1) = {"
g
v
a
a
a
a
a
v
g
"}
(9,1,1) = {"
g
g
g
g
g
g
g
g
g
"}
