//MAP CONVERTED BY dmm2tgm.py THIS HEADER COMMENT PREVENTS RECONVERSION, DO NOT REMOVE
"a" = (
/turf/template_noop,
/area/template_noop)
"e" = (
/obj/effect/landmark/vermin,
/obj/effect/auto_roof{
	roof_type = /turf/simulated/floor/plating/turfpack/muriki
	},
/turf/simulated/floor/plating,
/area/submap/outpost21/yard_cargocontainer)
"g" = (
/obj/machinery/door/airlock/angled_bay/standard/color/cargo{
	name = "Cargo Container"
	},
/obj/effect/auto_roof{
	roof_type = /turf/simulated/floor/plating/turfpack/muriki
	},
/turf/simulated/floor/plating,
/area/submap/outpost21/yard_cargocontainer)
"k" = (
/obj/structure/table/rack/shelf/steel,
/obj/random/maintenance,
/obj/effect/auto_roof{
	roof_type = /turf/simulated/floor/plating/turfpack/muriki
	},
/obj/random/contraband,
/turf/simulated/floor/plating,
/area/submap/outpost21/yard_cargocontainer)
"z" = (
/obj/structure/closet/crate,
/obj/random/maintenance,
/obj/random/maintenance,
/obj/random/maintenance,
/obj/random/maintenance,
/obj/random/maintenance,
/obj/random/maintenance,
/obj/random/maintenance,
/obj/random/maintenance,
/obj/effect/auto_roof{
	roof_type = /turf/simulated/floor/plating/turfpack/muriki
	},
/turf/simulated/floor/plating,
/area/submap/outpost21/yard_cargocontainer)
"B" = (
/obj/structure/table/rack/shelf/steel,
/obj/random/maintenance,
/obj/effect/auto_roof{
	roof_type = /turf/simulated/floor/plating/turfpack/muriki
	},
/turf/simulated/floor/plating,
/area/submap/outpost21/yard_cargocontainer)
"F" = (
/obj/structure/table/rack/shelf/steel,
/obj/random/maintenance,
/obj/random/junk,
/obj/effect/auto_roof{
	roof_type = /turf/simulated/floor/plating/turfpack/muriki
	},
/turf/simulated/floor/plating,
/area/submap/outpost21/yard_cargocontainer)
"K" = (
/obj/structure/closet/crate,
/obj/random/maintenance,
/obj/random/maintenance,
/obj/random/maintenance,
/obj/random/maintenance,
/obj/random/maintenance,
/obj/random/maintenance,
/obj/random/maintenance,
/obj/random/junk,
/obj/effect/auto_roof{
	roof_type = /turf/simulated/floor/plating/turfpack/muriki
	},
/obj/random/contraband,
/turf/simulated/floor/plating,
/area/submap/outpost21/yard_cargocontainer)
"L" = (
/obj/effect/auto_roof{
	roof_type = /turf/simulated/floor/plating/turfpack/muriki
	},
/turf/simulated/wall/bay/steel,
/area/submap/outpost21/yard_cargocontainer)
"R" = (
/turf/template_noop,
/area/submap/outpost21/yard_generic)
"V" = (
/obj/random/junk,
/obj/effect/auto_roof{
	roof_type = /turf/simulated/floor/plating/turfpack/muriki
	},
/turf/simulated/floor/plating,
/area/submap/outpost21/yard_cargocontainer)
"Y" = (
/obj/effect/auto_roof{
	roof_type = /turf/simulated/floor/plating/turfpack/muriki
	},
/turf/simulated/floor/plating,
/area/submap/outpost21/yard_cargocontainer)

(1,1,1) = {"
a
a
a
a
a
a
a
a
a
"}
(2,1,1) = {"
a
R
R
R
R
R
R
R
a
"}
(3,1,1) = {"
a
L
L
L
L
L
L
L
a
"}
(4,1,1) = {"
a
L
z
F
k
F
B
L
a
"}
(5,1,1) = {"
a
L
V
Y
e
V
Y
g
a
"}
(6,1,1) = {"
a
L
K
B
F
B
B
L
a
"}
(7,1,1) = {"
a
L
L
L
L
L
L
L
a
"}
(8,1,1) = {"
a
R
R
R
R
R
R
R
a
"}
(9,1,1) = {"
a
a
a
a
a
a
a
a
a
"}
