//MAP CONVERTED BY dmm2tgm.py THIS HEADER COMMENT PREVENTS RECONVERSION, DO NOT REMOVE
"a" = (
/turf/template_noop,
/area/template_noop)
"c" = (
/obj/structure/table/rack/shelf/steel,
/obj/random/maintenance,
/obj/random/junk,
/obj/effect/auto_roof{
	roof_type = /turf/simulated/floor/plating/turfpack/muriki
	},
/obj/random/contraband,
/turf/simulated/floor/plating,
/area/submap/outpost21/yard_cargocontainer)
"g" = (
/obj/machinery/door/airlock/angled_bay/standard/color/cargo{
	name = "Cargo Container"
	},
/obj/effect/auto_roof{
	roof_type = /turf/simulated/floor/plating/turfpack/muriki
	},
/turf/simulated/floor/plating,
/area/submap/outpost21/yard_cargocontainer)
"s" = (
/obj/effect/landmark/vermin,
/obj/effect/auto_roof{
	roof_type = /turf/simulated/floor/plating/turfpack/muriki
	},
/turf/simulated/floor/plating,
/area/submap/outpost21/yard_cargocontainer)
"u" = (
/obj/structure/closet/crate,
/obj/random/maintenance,
/obj/random/maintenance,
/obj/random/maintenance,
/obj/random/maintenance,
/obj/random/maintenance,
/obj/random/maintenance,
/obj/random/maintenance,
/obj/random/junk,
/obj/effect/auto_roof{
	roof_type = /turf/simulated/floor/plating/turfpack/muriki
	},
/turf/simulated/floor/plating,
/area/submap/outpost21/yard_cargocontainer)
"D" = (
/obj/effect/auto_roof{
	roof_type = /turf/simulated/floor/plating/turfpack/muriki
	},
/turf/simulated/floor/plating,
/area/submap/outpost21/yard_cargocontainer)
"F" = (
/obj/structure/table/rack/shelf/steel,
/obj/random/maintenance,
/obj/effect/auto_roof{
	roof_type = /turf/simulated/floor/plating/turfpack/muriki
	},
/turf/simulated/floor/plating,
/area/submap/outpost21/yard_cargocontainer)
"L" = (
/obj/effect/auto_roof{
	roof_type = /turf/simulated/floor/plating/turfpack/muriki
	},
/turf/simulated/wall/bay/steel,
/area/submap/outpost21/yard_cargocontainer)
"N" = (
/obj/structure/table/rack/shelf/steel,
/obj/random/maintenance,
/obj/effect/auto_roof{
	roof_type = /turf/simulated/floor/plating/turfpack/muriki
	},
/obj/random/contraband,
/turf/simulated/floor/plating,
/area/submap/outpost21/yard_cargocontainer)
"O" = (
/obj/structure/closet/crate,
/obj/random/maintenance,
/obj/random/maintenance,
/obj/random/maintenance,
/obj/random/maintenance,
/obj/random/maintenance,
/obj/random/maintenance,
/obj/random/maintenance,
/obj/random/maintenance,
/obj/effect/auto_roof{
	roof_type = /turf/simulated/floor/plating/turfpack/muriki
	},
/turf/simulated/floor/plating,
/area/submap/outpost21/yard_cargocontainer)
"P" = (
/obj/structure/table/rack/shelf/steel,
/obj/random/maintenance,
/obj/random/junk,
/obj/effect/auto_roof{
	roof_type = /turf/simulated/floor/plating/turfpack/muriki
	},
/turf/simulated/floor/plating,
/area/submap/outpost21/yard_cargocontainer)
"R" = (
/turf/template_noop,
/area/submap/outpost21/yard_generic)
"V" = (
/obj/random/junk,
/obj/effect/auto_roof{
	roof_type = /turf/simulated/floor/plating/turfpack/muriki
	},
/turf/simulated/floor/plating,
/area/submap/outpost21/yard_cargocontainer)

(1,1,1) = {"
a
a
a
a
a
a
a
a
a
"}
(2,1,1) = {"
a
R
R
R
R
R
R
R
a
"}
(3,1,1) = {"
a
L
L
L
L
L
L
L
a
"}
(4,1,1) = {"
a
L
P
F
P
N
O
L
a
"}
(5,1,1) = {"
a
g
D
V
s
D
V
L
a
"}
(6,1,1) = {"
a
L
F
c
F
F
u
L
a
"}
(7,1,1) = {"
a
L
L
L
L
L
L
L
a
"}
(8,1,1) = {"
a
R
R
R
R
R
R
R
a
"}
(9,1,1) = {"
a
a
a
a
a
a
a
a
a
"}
