//MAP CONVERTED BY dmm2tgm.py THIS HEADER COMMENT PREVENTS RECONVERSION, DO NOT REMOVE
"a" = (
/turf/template_noop,
/area/submap/outpost21/yard_generic)
"c" = (
/obj/effect/landmark/loot_spawn/low,
/obj/effect/landmark/loot_spawn/low,
/obj/effect/auto_roof{
	roof_type = /turf/simulated/floor/plating/turfpack/muriki
	},
/turf/simulated/floor/plating,
/area/submap/outpost21/yard_cargocontainer)
"i" = (
/obj/effect/auto_roof{
	roof_type = /turf/simulated/floor/plating/turfpack/muriki
	},
/turf/simulated/floor/plating,
/area/submap/outpost21/yard_cargocontainer)
"j" = (
/obj/random/potion_base,
/obj/random/potion_ingredient,
/obj/random/potion_ingredient,
/obj/structure/closet/crate,
/obj/effect/auto_roof{
	roof_type = /turf/simulated/floor/plating/turfpack/muriki
	},
/turf/simulated/floor/plating,
/area/submap/outpost21/yard_cargocontainer)
"m" = (
/obj/random/junk,
/obj/effect/auto_roof{
	roof_type = /turf/simulated/floor/plating/turfpack/muriki
	},
/turf/simulated/floor/plating,
/area/submap/outpost21/yard_cargocontainer)
"n" = (
/obj/random/pizzabox,
/obj/random/pizzabox,
/obj/structure/closet/crate,
/obj/effect/auto_roof{
	roof_type = /turf/simulated/floor/plating/turfpack/muriki
	},
/turf/simulated/floor/plating,
/area/submap/outpost21/yard_cargocontainer)
"q" = (
/obj/structure/closet/crate,
/obj/random/medical,
/obj/effect/auto_roof{
	roof_type = /turf/simulated/floor/plating/turfpack/muriki
	},
/turf/simulated/floor/plating,
/area/submap/outpost21/yard_cargocontainer)
"s" = (
/obj/random/maintenance/medical,
/obj/random/maintenance/medical,
/obj/structure/closet/crate,
/obj/effect/auto_roof{
	roof_type = /turf/simulated/floor/plating/turfpack/muriki
	},
/turf/simulated/floor/plating,
/area/submap/outpost21/yard_cargocontainer)
"t" = (
/obj/machinery/door/airlock/angled_bay/standard/color/cargo{
	dir = 4;
	name = "Cargo Container"
	},
/obj/effect/auto_roof{
	roof_type = /turf/simulated/floor/plating/turfpack/muriki
	},
/turf/simulated/floor/plating,
/area/submap/outpost21/yard_cargocontainer)
"z" = (
/obj/random/material/refined,
/obj/random/material/refined,
/obj/random/material/refined,
/obj/random/material/refined,
/obj/random/material/refined,
/obj/random/material/refined,
/obj/random/material/refined,
/obj/random/material/refined,
/obj/structure/closet/crate,
/obj/effect/auto_roof{
	roof_type = /turf/simulated/floor/plating/turfpack/muriki
	},
/turf/simulated/floor/plating,
/area/submap/outpost21/yard_cargocontainer)
"E" = (
/obj/random/crate,
/obj/effect/auto_roof{
	roof_type = /turf/simulated/floor/plating/turfpack/muriki
	},
/turf/simulated/floor/plating,
/area/submap/outpost21/yard_cargocontainer)
"K" = (
/obj/random/mega_nukies,
/obj/random/mega_nukies,
/obj/random/nukies_can_legal,
/obj/structure/closet/crate,
/obj/effect/auto_roof{
	roof_type = /turf/simulated/floor/plating/turfpack/muriki
	},
/turf/simulated/floor/plating,
/area/submap/outpost21/yard_cargocontainer)
"Q" = (
/turf/template_noop,
/area/template_noop)
"S" = (
/obj/effect/auto_roof{
	roof_type = /turf/simulated/floor/plating/turfpack/muriki
	},
/turf/simulated/wall/bay/steel,
/area/submap/outpost21/yard_cargocontainer)

(1,1,1) = {"
Q
Q
Q
Q
Q
Q
Q
Q
Q
"}
(2,1,1) = {"
Q
a
S
S
t
S
S
a
Q
"}
(3,1,1) = {"
Q
a
S
s
i
n
S
a
Q
"}
(4,1,1) = {"
Q
a
S
j
m
z
S
a
Q
"}
(5,1,1) = {"
Q
a
S
c
i
z
S
a
Q
"}
(6,1,1) = {"
Q
a
S
q
i
E
S
a
Q
"}
(7,1,1) = {"
Q
a
S
K
m
E
S
a
Q
"}
(8,1,1) = {"
Q
a
S
S
S
S
S
a
Q
"}
(9,1,1) = {"
Q
Q
Q
Q
Q
Q
Q
Q
Q
"}
