//MAP CONVERTED BY dmm2tgm.py THIS HEADER COMMENT PREVENTS RECONVERSION, DO NOT REMOVE
"a" = (
/obj/effect/auto_roof{
	roof_type = /turf/simulated/floor/plating/turfpack/muriki
	},
/turf/simulated/wall/bay/steel,
/area/submap/outpost21/yard_cargocontainer)
"e" = (
/turf/template_noop,
/area/submap/outpost21/yard_generic)
"l" = (
/obj/effect/auto_roof{
	roof_type = /turf/simulated/floor/plating/turfpack/muriki
	},
/obj/random/cutout,
/turf/simulated/floor/plating,
/area/submap/outpost21/yard_cargocontainer)
"s" = (
/obj/random/junk,
/obj/effect/auto_roof{
	roof_type = /turf/simulated/floor/plating/turfpack/muriki
	},
/obj/random/cash,
/turf/simulated/floor/plating,
/area/submap/outpost21/yard_cargocontainer)
"v" = (
/obj/effect/auto_roof{
	roof_type = /turf/simulated/floor/plating/turfpack/muriki
	},
/turf/simulated/floor/plating,
/area/submap/outpost21/yard_cargocontainer)
"z" = (
/obj/effect/auto_roof{
	roof_type = /turf/simulated/floor/plating/turfpack/muriki
	},
/obj/random/junk,
/turf/simulated/floor/plating,
/area/submap/outpost21/yard_cargocontainer)
"E" = (
/obj/random/junk,
/obj/effect/auto_roof{
	roof_type = /turf/simulated/floor/plating/turfpack/muriki
	},
/turf/simulated/floor/plating,
/area/submap/outpost21/yard_cargocontainer)
"G" = (
/turf/template_noop,
/area/template_noop)
"Q" = (
/obj/machinery/door/airlock/angled_bay/standard/color/cargo{
	dir = 4;
	name = "Cargo Container"
	},
/obj/effect/auto_roof{
	roof_type = /turf/simulated/floor/plating/turfpack/muriki
	},
/turf/simulated/floor/plating,
/area/submap/outpost21/yard_cargocontainer)
"U" = (
/obj/effect/auto_roof{
	roof_type = /turf/simulated/floor/plating/turfpack/muriki
	},
/obj/random/contraband,
/turf/simulated/floor/plating,
/area/submap/outpost21/yard_cargocontainer)

(1,1,1) = {"
G
G
G
G
G
G
G
G
G
"}
(2,1,1) = {"
G
e
a
a
Q
a
a
e
G
"}
(3,1,1) = {"
G
e
a
E
v
U
a
e
G
"}
(4,1,1) = {"
G
e
a
U
v
E
a
e
G
"}
(5,1,1) = {"
G
e
a
l
E
s
a
e
G
"}
(6,1,1) = {"
G
e
a
l
z
E
a
e
G
"}
(7,1,1) = {"
G
e
a
l
v
l
a
e
G
"}
(8,1,1) = {"
G
e
a
a
a
a
a
e
G
"}
(9,1,1) = {"
G
G
G
G
G
G
G
G
G
"}
