//MAP CONVERTED BY dmm2tgm.py THIS HEADER COMMENT PREVENTS RECONVERSION, DO NOT REMOVE
"a" = (
/turf/template_noop,
/area/template_noop)
"c" = (
/turf/simulated/mineral/floor/turfpack/muriki{
	ignore_mapgen = 1
	},
/area/submap/outpost21/yard_generic)
"d" = (
/turf/template_noop,
/area/submap/outpost21/yard_generic)
"e" = (
/turf/simulated/mineral/alt/ignore_mapgen/turfpack/muriki,
/area/submap/outpost21/yard_generic)
"j" = (
/obj/effect/landmark/hostile_xenobio,
/turf/simulated/mineral/floor/turfpack/muriki{
	ignore_mapgen = 1
	},
/area/submap/outpost21/yard_generic)
"o" = (
/turf/simulated/floor/outdoors/mud/turfpack/muriki,
/area/submap/outpost21/yard_generic)
"B" = (
/obj/random/outcrop,
/turf/simulated/floor/outdoors/newdirt_nograss/turfpack/muriki,
/area/submap/outpost21/yard_generic)
"F" = (
/obj/random/outcrop,
/turf/simulated/floor/outdoors/mud/turfpack/muriki,
/area/submap/outpost21/yard_generic)
"I" = (
/turf/simulated/floor/outdoors/newdirt_nograss/turfpack/muriki,
/area/submap/outpost21/yard_generic)

(1,1,1) = {"
a
a
a
a
a
a
a
a
a
a
a
"}
(2,1,1) = {"
a
a
F
o
o
o
I
a
a
a
a
"}
(3,1,1) = {"
a
a
o
I
B
e
e
o
o
a
a
"}
(4,1,1) = {"
a
o
I
I
e
e
e
e
I
a
a
"}
(5,1,1) = {"
a
o
o
e
e
j
c
e
o
o
a
"}
(6,1,1) = {"
a
o
o
e
e
c
c
I
B
o
a
"}
(7,1,1) = {"
a
o
B
e
e
e
e
I
I
o
a
"}
(8,1,1) = {"
a
o
I
o
e
e
B
I
o
o
a
"}
(9,1,1) = {"
a
a
o
o
I
o
o
I
I
F
a
"}
(10,1,1) = {"
a
a
d
F
o
o
I
I
o
a
a
"}
(11,1,1) = {"
a
a
a
a
a
a
a
a
a
a
a
"}
