//MAP CONVERTED BY dmm2tgm.py THIS HEADER COMMENT PREVENTS RECONVERSION, DO NOT REMOVE
"a" = (
/turf/template_noop,
/area/template_noop)
"b" = (
/obj/random/contraband,
/obj/effect/auto_roof{
	roof_type = /turf/simulated/floor/plating/external/turfpack/muriki
	},
/turf/simulated/floor/tiled/turfpack/muriki,
/area/submap/outpost21/yard_generic)
"c" = (
/turf/simulated/wall,
/area/submap/outpost21/yard_generic)
"d" = (
/turf/template_noop,
/area/submap/outpost21/yard_generic)
"e" = (
/turf/simulated/floor/outdoors/mud/turfpack/muriki,
/area/submap/outpost21/yard_generic)
"f" = (
/obj/random/tool,
/obj/effect/auto_roof{
	roof_type = /turf/simulated/floor/plating/external/turfpack/muriki
	},
/turf/simulated/floor/tiled/turfpack/muriki,
/area/submap/outpost21/yard_generic)
"g" = (
/obj/effect/auto_roof{
	roof_type = /turf/simulated/floor/plating/external/turfpack/muriki
	},
/turf/simulated/floor/tiled/turfpack/muriki,
/area/submap/outpost21/yard_generic)
"h" = (
/obj/random/maintenance,
/turf/simulated/floor/plating/external/turfpack/muriki,
/area/submap/outpost21/yard_generic)
"i" = (
/obj/random/maintenance,
/obj/effect/auto_roof{
	roof_type = /turf/simulated/floor/plating/external/turfpack/muriki
	},
/turf/simulated/floor/tiled/turfpack/muriki,
/area/submap/outpost21/yard_generic)
"j" = (
/obj/random/material,
/obj/random/material,
/obj/effect/auto_roof{
	roof_type = /turf/simulated/floor/plating/external/turfpack/muriki
	},
/turf/simulated/floor/tiled/turfpack/muriki,
/area/submap/outpost21/yard_generic)
"k" = (
/obj/random/material,
/obj/effect/auto_roof{
	roof_type = /turf/simulated/floor/plating/external/turfpack/muriki
	},
/turf/simulated/floor/tiled/turfpack/muriki,
/area/submap/outpost21/yard_generic)
"l" = (
/obj/random/toolbox,
/obj/effect/auto_roof{
	roof_type = /turf/simulated/floor/plating/external/turfpack/muriki
	},
/turf/simulated/floor/plating/external/turfpack/muriki,
/area/submap/outpost21/yard_generic)
"m" = (
/obj/random/firstaid,
/obj/effect/auto_roof{
	roof_type = /turf/simulated/floor/plating/external/turfpack/muriki
	},
/turf/simulated/floor/tiled/turfpack/muriki,
/area/submap/outpost21/yard_generic)
"n" = (
/obj/random/material,
/obj/effect/auto_roof{
	roof_type = /turf/simulated/floor/plating/external/turfpack/muriki
	},
/turf/simulated/floor/plating/external/turfpack/muriki,
/area/submap/outpost21/yard_generic)
"w" = (
/turf/simulated/floor/plating/external/turfpack/muriki,
/area/submap/outpost21/yard_generic)
"x" = (
/obj/effect/auto_roof{
	roof_type = /turf/simulated/floor/plating/external/turfpack/muriki
	},
/turf/simulated/wall,
/area/submap/outpost21/yard_generic)
"y" = (
/obj/random/contraband,
/turf/simulated/floor/outdoors/mud/turfpack/muriki,
/area/submap/outpost21/yard_generic)
"A" = (
/obj/effect/auto_roof{
	roof_type = /turf/simulated/floor/plating/external/turfpack/muriki
	},
/turf/simulated/floor/plating/external/turfpack/muriki,
/area/submap/outpost21/yard_generic)
"E" = (
/obj/machinery/door/airlock/engineering,
/obj/effect/auto_roof{
	roof_type = /turf/simulated/floor/plating/external/turfpack/muriki
	},
/turf/simulated/floor/plating/external/turfpack/muriki,
/area/submap/outpost21/yard_generic)
"R" = (
/obj/random/maintenance,
/obj/random/maintenance,
/obj/effect/auto_roof{
	roof_type = /turf/simulated/floor/plating/external/turfpack/muriki
	},
/turf/simulated/floor/plating/external/turfpack/muriki,
/area/submap/outpost21/yard_generic)
"S" = (
/obj/random/maintenance,
/turf/simulated/floor/outdoors/mud/turfpack/muriki,
/area/submap/outpost21/yard_generic)
"W" = (
/obj/effect/auto_roof{
	roof_type = /turf/simulated/floor/plating/external/turfpack/muriki
	},
/turf/simulated/floor/outdoors/mud/turfpack/muriki,
/area/submap/outpost21/yard_generic)
"X" = (
/obj/random/maintenance,
/obj/effect/auto_roof{
	roof_type = /turf/simulated/floor/plating/external/turfpack/muriki
	},
/turf/simulated/floor/plating/external/turfpack/muriki,
/area/submap/outpost21/yard_generic)

(1,1,1) = {"
a
a
a
a
a
a
a
a
a
a
a
a
a
"}
(2,1,1) = {"
a
d
d
d
d
d
d
d
d
d
d
d
a
"}
(3,1,1) = {"
a
d
x
x
x
d
d
d
S
e
d
d
a
"}
(4,1,1) = {"
a
d
x
R
X
e
x
x
W
E
x
x
a
"}
(5,1,1) = {"
a
d
d
d
d
S
x
f
g
X
A
x
a
"}
(6,1,1) = {"
a
d
c
d
d
d
x
i
j
g
m
x
a
"}
(7,1,1) = {"
a
d
e
y
w
d
x
l
g
b
A
x
a
"}
(8,1,1) = {"
a
d
e
x
b
x
x
A
n
k
f
x
a
"}
(9,1,1) = {"
a
d
e
x
f
E
g
A
j
A
g
x
a
"}
(10,1,1) = {"
a
d
e
x
A
x
W
x
x
E
x
x
a
"}
(11,1,1) = {"
a
d
d
c
e
d
d
d
w
w
h
d
a
"}
(12,1,1) = {"
a
d
d
d
d
d
d
d
d
d
d
d
a
"}
(13,1,1) = {"
a
a
a
a
a
a
a
a
a
a
a
a
a
"}
