//MAP CONVERTED BY dmm2tgm.py THIS HEADER COMMENT PREVENTS RECONVERSION, DO NOT REMOVE
"a" = (
/turf/template_noop,
/area/template_noop)
"g" = (
/obj/machinery/trailblazer/yellow,
/turf/template_noop,
/area/submap/outpost21/yard_generic)
"R" = (
/turf/simulated/floor/outdoors/sidewalk/turfpack/muriki{
	icon_state = "slab"
	},
/area/submap/outpost21/yard_generic)
"W" = (
/turf/template_noop,
/area/submap/outpost21/yard_generic)

(1,1,1) = {"
a
a
a
a
a
"}
(2,1,1) = {"
a
W
R
W
a
"}
(3,1,1) = {"
a
W
g
R
a
"}
(4,1,1) = {"
a
R
W
R
a
"}
(5,1,1) = {"
a
a
a
a
a
"}
