//MAP CONVERTED BY dmm2tgm.py THIS HEADER COMMENT PREVENTS RECONVERSION, DO NOT REMOVE
"a" = (
/turf/template_noop,
/area/template_noop)
"g" = (
/turf/simulated/floor/outdoors/sidewalk/turfpack/muriki{
	icon_state = "slab"
	},
/area/submap/outpost21/yard_generic)
"Z" = (
/turf/template_noop,
/area/submap/outpost21/yard_generic)

(1,1,1) = {"
a
a
a
"}
(2,1,1) = {"
a
g
a
"}
(3,1,1) = {"
a
Z
a
"}
(4,1,1) = {"
a
g
a
"}
(5,1,1) = {"
a
g
a
"}
(6,1,1) = {"
a
Z
a
"}
(7,1,1) = {"
a
a
a
"}
