//MAP CONVERTED BY dmm2tgm.py THIS HEADER COMMENT PREVENTS RECONVERSION, DO NOT REMOVE
"a" = (
/turf/template_noop,
/area/template_noop)
"e" = (
/turf/simulated/floor/outdoors/sidewalk/turfpack/muriki{
	icon_state = "slab"
	},
/area/submap/outpost21/yard_generic)
"J" = (
/turf/template_noop,
/area/submap/outpost21/yard_generic)

(1,1,1) = {"
a
a
a
a
a
a
a
"}
(2,1,1) = {"
a
e
J
e
e
J
a
"}
(3,1,1) = {"
a
a
a
a
a
a
a
"}
