//MAP CONVERTED BY dmm2tgm.py THIS HEADER COMMENT PREVENTS RECONVERSION, DO NOT REMOVE
"a" = (
/turf/template_noop,
/area/template_noop)
"d" = (
/obj/random/maintenance,
/obj/random/maintenance,
/turf/simulated/floor/outdoors/mud/turfpack/muriki,
/area/submap/outpost21/yard_generic)
"g" = (
/turf/simulated/floor/outdoors/sidewalk/turfpack/muriki{
	icon_state = "slab"
	},
/area/submap/outpost21/yard_generic)
"h" = (
/turf/simulated/floor/outdoors/mud/turfpack/muriki,
/area/submap/outpost21/yard_generic)
"m" = (
/obj/random/firstaid,
/turf/simulated/floor/outdoors/mud/turfpack/muriki,
/area/submap/outpost21/yard_generic)
"A" = (
/obj/random/flashlight,
/turf/simulated/floor/outdoors/mud/turfpack/muriki,
/area/submap/outpost21/yard_generic)
"D" = (
/mob/living/simple_mob/vore/alienanimals/jil,
/turf/simulated/floor/outdoors/mud/turfpack/muriki,
/area/submap/outpost21/yard_generic)
"G" = (
/obj/machinery/trailblazer/yellow,
/turf/simulated/floor/outdoors/mud/turfpack/muriki,
/area/submap/outpost21/yard_generic)
"M" = (
/obj/random/maintenance,
/turf/simulated/floor/outdoors/mud/turfpack/muriki,
/area/submap/outpost21/yard_generic)
"N" = (
/turf/template_noop,
/area/submap/outpost21/yard_generic)

(1,1,1) = {"
a
a
a
a
a
a
a
"}
(2,1,1) = {"
a
h
g
d
N
M
a
"}
(3,1,1) = {"
a
N
D
m
M
g
a
"}
(4,1,1) = {"
a
d
N
G
h
N
a
"}
(5,1,1) = {"
a
N
N
D
A
d
a
"}
(6,1,1) = {"
a
g
h
d
N
N
a
"}
(7,1,1) = {"
a
a
a
a
a
a
a
"}
