//MAP CONVERTED BY dmm2tgm.py THIS HEADER COMMENT PREVENTS RECONVERSION, DO NOT REMOVE
"a" = (
/turf/template_noop,
/area/submap/outpost21/yard_generic)
"e" = (
/obj/structure/cliff{
	dir = 1
	},
/turf/simulated/floor/outdoors/mud/turfpack/muriki,
/area/submap/outpost21/yard_generic)
"i" = (
/obj/structure/cliff{
	dir = 10
	},
/turf/simulated/floor/outdoors/mud/turfpack/muriki,
/area/submap/outpost21/yard_generic)
"n" = (
/turf/simulated/floor/outdoors/mud/turfpack/muriki,
/area/submap/outpost21/yard_generic)
"p" = (
/obj/structure/cliff/corner{
	dir = 6
	},
/turf/simulated/floor/outdoors/mud/turfpack/muriki,
/area/submap/outpost21/yard_generic)
"r" = (
/obj/structure/cliff_end{
	dir = 1
	},
/turf/simulated/floor/outdoors/mud/turfpack/muriki,
/area/submap/outpost21/yard_generic)
"s" = (
/obj/structure/cliff/corner{
	dir = 5
	},
/turf/simulated/floor/outdoors/mud/turfpack/muriki,
/area/submap/outpost21/yard_generic)
"A" = (
/obj/structure/cliff/corner{
	dir = 9
	},
/turf/simulated/floor/outdoors/mud/turfpack/muriki,
/area/submap/outpost21/yard_generic)
"D" = (
/obj/structure/cliff{
	dir = 6
	},
/turf/simulated/floor/outdoors/mud/turfpack/muriki,
/area/submap/outpost21/yard_generic)
"G" = (
/obj/structure/cliff{
	dir = 9
	},
/turf/simulated/floor/outdoors/mud/turfpack/muriki,
/area/submap/outpost21/yard_generic)
"K" = (
/turf/template_noop,
/area/template_noop)
"O" = (
/obj/structure/cliff,
/turf/simulated/floor/outdoors/mud/turfpack/muriki,
/area/submap/outpost21/yard_generic)
"P" = (
/obj/structure/cliff{
	dir = 8
	},
/turf/simulated/floor/outdoors/mud/turfpack/muriki,
/area/submap/outpost21/yard_generic)
"R" = (
/obj/structure/cliff_end{
	dir = 4
	},
/turf/simulated/floor/outdoors/mud/turfpack/muriki,
/area/submap/outpost21/yard_generic)
"V" = (
/obj/structure/cliff{
	dir = 5
	},
/turf/simulated/floor/outdoors/mud/turfpack/muriki,
/area/submap/outpost21/yard_generic)
"W" = (
/obj/structure/cliff_end{
	dir = 8
	},
/turf/simulated/floor/outdoors/mud/turfpack/muriki,
/area/submap/outpost21/yard_generic)
"Y" = (
/obj/structure/cliff{
	dir = 4
	},
/turf/simulated/floor/outdoors/mud/turfpack/muriki,
/area/submap/outpost21/yard_generic)
"Z" = (
/obj/structure/cliff/corner{
	dir = 10
	},
/turf/simulated/floor/outdoors/mud/turfpack/muriki,
/area/submap/outpost21/yard_generic)

(1,1,1) = {"
K
K
K
K
K
K
K
K
K
K
K
K
K
K
K
K
K
K
K
K
K
K
K
K
K
"}
(2,1,1) = {"
K
K
K
K
K
K
K
K
K
K
K
K
K
K
K
K
K
K
K
K
K
K
K
K
K
"}
(3,1,1) = {"
K
K
K
K
K
K
K
a
n
n
n
n
n
n
n
n
n
a
a
a
a
a
a
K
K
"}
(4,1,1) = {"
K
K
K
K
K
a
a
n
n
A
P
P
P
Z
n
n
n
n
n
n
n
a
a
K
K
"}
(5,1,1) = {"
K
K
K
K
K
a
n
n
A
G
n
n
n
i
P
P
P
P
Z
n
n
n
a
a
K
"}
(6,1,1) = {"
K
K
K
a
a
n
A
P
G
n
K
K
K
n
n
n
n
n
i
P
P
r
n
a
K
"}
(7,1,1) = {"
K
K
K
n
R
n
e
n
n
K
K
K
K
K
K
K
K
K
n
n
n
n
n
a
K
"}
(8,1,1) = {"
K
K
a
n
e
n
e
n
K
K
K
K
K
K
K
K
K
K
K
n
n
n
n
a
K
"}
(9,1,1) = {"
K
K
a
n
e
n
W
K
K
K
K
K
K
K
K
K
K
K
K
K
n
R
n
a
K
"}
(10,1,1) = {"
K
K
a
n
e
n
K
K
K
K
K
K
K
K
K
K
K
K
K
K
n
O
n
a
K
"}
(11,1,1) = {"
K
K
K
n
e
n
K
K
K
K
K
K
K
K
K
K
K
K
K
K
n
O
n
a
K
"}
(12,1,1) = {"
K
K
K
n
e
n
K
K
K
K
K
K
K
K
K
K
K
K
K
K
n
O
n
n
K
"}
(13,1,1) = {"
K
K
K
n
e
n
K
K
K
K
K
K
K
K
K
K
K
K
K
K
n
i
Z
n
K
"}
(14,1,1) = {"
K
K
K
n
e
n
K
K
K
K
K
K
K
K
K
K
K
K
K
K
K
n
O
n
K
"}
(15,1,1) = {"
K
K
K
n
e
n
K
K
K
K
K
K
K
K
K
K
K
K
K
K
K
n
O
n
K
"}
(16,1,1) = {"
K
K
K
n
s
V
n
K
K
K
K
K
K
K
K
K
K
K
K
K
n
n
O
n
K
"}
(17,1,1) = {"
K
K
K
n
n
e
n
K
K
K
K
K
K
K
K
K
K
K
K
K
D
Y
p
n
K
"}
(18,1,1) = {"
K
K
K
a
n
e
n
K
K
K
K
K
K
K
K
K
K
K
K
n
O
n
n
n
K
"}
(19,1,1) = {"
K
K
K
a
n
s
V
n
K
K
K
K
K
K
K
K
K
n
n
n
O
n
n
a
K
"}
(20,1,1) = {"
K
K
K
a
n
n
s
V
n
n
K
K
K
K
K
K
n
D
Y
Y
p
n
a
K
K
"}
(21,1,1) = {"
K
K
K
a
a
n
n
s
Y
V
n
n
n
n
n
n
n
O
n
n
n
a
a
K
K
"}
(22,1,1) = {"
K
K
K
a
a
n
n
n
n
e
n
n
n
n
n
D
Y
p
n
n
a
a
K
K
K
"}
(23,1,1) = {"
K
K
K
a
a
a
a
n
n
s
Y
Y
Y
V
n
O
n
n
a
a
a
a
K
K
K
"}
(24,1,1) = {"
K
K
K
K
K
a
a
a
n
n
n
n
n
W
n
W
n
a
a
a
K
K
K
K
K
"}
(25,1,1) = {"
K
K
K
K
K
K
K
K
K
K
K
K
K
K
K
K
K
K
K
K
K
K
K
K
K
"}
