//MAP CONVERTED BY dmm2tgm.py THIS HEADER COMMENT PREVENTS RECONVERSION, DO NOT REMOVE
"a" = (
/turf/template_noop,
/area/submap/outpost21/yard_generic)
"b" = (
/turf/simulated/floor/outdoors/mud/turfpack/muriki,
/area/submap/outpost21/yard_generic)
"c" = (
/obj/structure/cliff{
	dir = 9
	},
/turf/simulated/floor/outdoors/mud/turfpack/muriki,
/area/submap/outpost21/yard_generic)
"l" = (
/turf/simulated/floor/outdoors/mud/turfpack/muriki,
/area/submap/outpost21/yard_sinkhole)
"n" = (
/obj/structure/cliff/corner{
	dir = 6
	},
/turf/simulated/floor/outdoors/mud/turfpack/muriki,
/area/submap/outpost21/yard_generic)
"u" = (
/obj/structure/cliff{
	dir = 5
	},
/turf/simulated/floor/outdoors/mud/turfpack/muriki,
/area/submap/outpost21/yard_generic)
"w" = (
/obj/structure/cliff_end{
	dir = 8
	},
/turf/simulated/floor/outdoors/mud/turfpack/muriki,
/area/submap/outpost21/yard_generic)
"x" = (
/obj/structure/cliff_end,
/turf/simulated/floor/outdoors/mud/turfpack/muriki,
/area/submap/outpost21/yard_generic)
"z" = (
/turf/template_noop,
/area/template_noop)
"A" = (
/obj/structure/cliff_end{
	dir = 4
	},
/turf/simulated/floor/outdoors/mud/turfpack/muriki,
/area/submap/outpost21/yard_generic)
"C" = (
/obj/structure/cliff{
	dir = 10
	},
/turf/simulated/floor/outdoors/mud/turfpack/muriki,
/area/submap/outpost21/yard_generic)
"E" = (
/turf/simulated/open/muriki,
/area/submap/outpost21/yard_sinkhole)
"G" = (
/obj/structure/cliff/corner{
	dir = 9
	},
/turf/simulated/floor/outdoors/mud/turfpack/muriki,
/area/submap/outpost21/yard_generic)
"H" = (
/obj/structure/cliff_end{
	dir = 1
	},
/turf/simulated/floor/outdoors/mud/turfpack/muriki,
/area/submap/outpost21/yard_generic)
"N" = (
/obj/structure/cliff{
	dir = 4
	},
/turf/simulated/floor/outdoors/mud/turfpack/muriki,
/area/submap/outpost21/yard_generic)
"O" = (
/obj/structure/cliff{
	dir = 6
	},
/turf/simulated/floor/outdoors/mud/turfpack/muriki,
/area/submap/outpost21/yard_generic)
"P" = (
/obj/structure/cliff/corner{
	dir = 5
	},
/turf/simulated/floor/outdoors/mud/turfpack/muriki,
/area/submap/outpost21/yard_generic)
"U" = (
/obj/structure/cliff/corner{
	dir = 10
	},
/turf/simulated/floor/outdoors/mud/turfpack/muriki,
/area/submap/outpost21/yard_generic)
"W" = (
/obj/structure/cliff,
/turf/simulated/floor/outdoors/mud/turfpack/muriki,
/area/submap/outpost21/yard_generic)
"X" = (
/obj/structure/cliff{
	dir = 8
	},
/turf/simulated/floor/outdoors/mud/turfpack/muriki,
/area/submap/outpost21/yard_generic)
"Y" = (
/obj/structure/cliff{
	dir = 1
	},
/turf/simulated/floor/outdoors/mud/turfpack/muriki,
/area/submap/outpost21/yard_generic)

(1,1,1) = {"
z
z
z
z
z
z
z
z
z
z
z
z
z
z
z
"}
(2,1,1) = {"
z
z
z
z
z
z
z
z
z
z
z
z
z
z
z
"}
(3,1,1) = {"
z
z
z
z
A
b
b
b
A
a
a
z
z
z
z
"}
(4,1,1) = {"
z
z
z
b
W
b
b
b
Y
b
b
A
a
z
z
"}
(5,1,1) = {"
z
z
z
b
C
X
X
X
c
b
b
W
b
z
z
"}
(6,1,1) = {"
z
z
b
b
b
b
G
X
U
b
b
W
b
a
z
"}
(7,1,1) = {"
z
z
x
N
u
G
c
l
C
X
U
W
b
a
z
"}
(8,1,1) = {"
z
z
a
b
Y
Y
l
E
E
l
W
W
b
b
z
"}
(9,1,1) = {"
z
z
a
b
Y
P
u
l
l
O
n
C
X
H
z
"}
(10,1,1) = {"
z
z
a
b
w
b
P
N
N
n
b
b
b
a
z
"}
(11,1,1) = {"
z
z
a
b
x
N
N
N
N
N
N
H
a
z
z
"}
(12,1,1) = {"
z
z
z
a
b
b
b
b
b
b
b
b
z
z
z
"}
(13,1,1) = {"
z
z
z
z
a
a
b
b
b
b
a
z
z
z
z
"}
(14,1,1) = {"
z
z
z
z
z
z
z
z
z
z
z
z
z
z
z
"}
(15,1,1) = {"
z
z
z
z
z
z
z
z
z
z
z
z
z
z
z
"}
