//MAP CONVERTED BY dmm2tgm.py THIS HEADER COMMENT PREVENTS RECONVERSION, DO NOT REMOVE
"a" = (
/turf/template_noop,
/area/mine/explored/muriki/cave/deepdark)
"h" = (
/turf/template_noop,
/area/template_noop)
"m" = (
/turf/simulated/wall/durasteel,
/area/mine/explored/muriki/cave/deepdark)
"n" = (
/turf/simulated/floor/flesh/turfpack/muriki,
/area/mine/explored/muriki/cave/deepdark)
"y" = (
/obj/structure/sign/signnew/biohazard,
/turf/simulated/wall/durasteel,
/area/mine/explored/muriki/cave/deepdark)
"B" = (
/turf/simulated/mineral/floor/ignore_cavegen/turfpack/muriki,
/area/mine/explored/muriki/cave/deepdark)
"F" = (
/obj/machinery/door/flesh,
/turf/simulated/floor/flesh/turfpack/muriki,
/area/mine/explored/muriki/cave/deepdark)
"T" = (
/turf/simulated/flesh,
/area/mine/explored/muriki/cave/deepdark)

(1,1,1) = {"
h
h
h
h
h
h
h
h
h
h
h
h
h
h
h
h
h
h
h
h
"}
(2,1,1) = {"
h
a
a
a
a
a
a
a
a
a
a
a
a
a
a
a
a
a
a
h
"}
(3,1,1) = {"
h
a
a
a
a
a
a
a
a
a
a
a
a
a
a
a
a
a
a
h
"}
(4,1,1) = {"
h
a
a
a
a
a
m
m
B
B
B
m
m
a
a
a
a
a
a
h
"}
(5,1,1) = {"
h
a
a
B
B
y
m
m
m
y
m
m
m
y
a
a
a
a
a
h
"}
(6,1,1) = {"
h
a
B
B
m
m
F
T
T
F
T
F
T
m
m
B
a
a
a
h
"}
(7,1,1) = {"
h
a
B
m
m
T
n
T
n
n
T
n
n
T
m
m
a
a
a
h
"}
(8,1,1) = {"
h
a
B
m
m
F
n
T
n
T
T
F
T
T
m
m
a
a
a
h
"}
(9,1,1) = {"
h
a
B
B
m
T
n
F
n
F
n
n
n
T
m
B
a
a
a
h
"}
(10,1,1) = {"
h
a
B
B
y
F
n
T
T
n
n
T
n
F
y
B
a
a
a
h
"}
(11,1,1) = {"
h
a
B
B
m
T
n
F
n
n
T
T
n
T
m
B
a
a
a
h
"}
(12,1,1) = {"
h
a
B
m
m
F
n
T
T
n
n
F
F
T
m
m
a
a
a
h
"}
(13,1,1) = {"
h
a
a
m
m
T
T
n
T
n
T
T
T
T
m
m
a
a
a
h
"}
(14,1,1) = {"
h
a
a
a
m
m
T
F
T
F
m
T
T
m
m
a
a
a
a
h
"}
(15,1,1) = {"
h
a
a
a
a
y
m
m
m
y
m
m
m
y
B
a
a
a
a
h
"}
(16,1,1) = {"
h
a
a
a
a
a
m
m
a
a
a
m
m
a
a
a
a
a
a
h
"}
(17,1,1) = {"
h
a
a
a
a
a
a
a
a
a
a
a
a
a
a
a
a
a
a
h
"}
(18,1,1) = {"
h
a
a
a
a
a
a
a
a
a
a
a
a
a
a
a
a
a
a
h
"}
(19,1,1) = {"
h
a
a
a
a
a
a
a
a
a
a
a
a
a
a
a
a
a
a
h
"}
(20,1,1) = {"
h
h
h
h
h
h
h
h
h
h
h
h
h
h
h
h
h
h
h
h
"}
