//MAP CONVERTED BY dmm2tgm.py THIS HEADER COMMENT PREVENTS RECONVERSION, DO NOT REMOVE
"a" = (
/turf/template_noop,
/area/template_noop)
"w" = (
/turf/simulated/mineral/floor/ignore_cavegen/turfpack/muriki,
/area/mine/unexplored/muriki/cave/deepdark)
"J" = (
/turf/template_noop,
/area/mine/unexplored/muriki/cave/deepdark)

(1,1,1) = {"
a
a
a
a
a
a
a
a
a
a
a
a
a
a
a
a
a
a
a
a
"}
(2,1,1) = {"
a
J
J
w
w
J
J
J
J
J
J
w
w
w
J
J
J
J
J
a
"}
(3,1,1) = {"
a
J
w
w
w
w
w
J
J
J
J
w
w
w
w
J
J
J
J
a
"}
(4,1,1) = {"
a
J
w
w
w
w
w
J
J
J
J
w
w
w
w
w
J
J
J
a
"}
(5,1,1) = {"
a
J
w
w
w
w
w
w
J
J
J
w
w
w
w
w
J
J
J
a
"}
(6,1,1) = {"
a
w
w
w
w
w
w
w
w
J
J
J
w
w
w
w
w
J
J
a
"}
(7,1,1) = {"
a
w
w
w
w
w
w
w
w
J
J
J
w
w
w
w
w
w
J
a
"}
(8,1,1) = {"
a
w
w
w
w
w
w
w
w
J
J
w
w
w
w
w
w
w
J
a
"}
(9,1,1) = {"
a
w
w
w
w
w
w
w
J
J
J
w
w
w
w
w
w
w
J
a
"}
(10,1,1) = {"
a
w
w
w
w
w
w
w
J
J
J
w
w
w
w
w
w
w
w
a
"}
(11,1,1) = {"
a
J
w
w
w
w
w
w
w
J
J
w
w
w
w
w
w
w
w
a
"}
(12,1,1) = {"
a
J
w
w
w
w
w
w
w
w
w
w
w
w
w
w
w
w
w
a
"}
(13,1,1) = {"
a
J
J
w
w
w
w
w
w
w
w
w
w
w
w
w
w
w
w
a
"}
(14,1,1) = {"
a
J
J
J
w
w
w
w
w
w
w
w
w
w
w
w
w
w
J
a
"}
(15,1,1) = {"
a
J
J
J
J
w
w
w
w
w
w
w
w
w
w
w
w
w
J
a
"}
(16,1,1) = {"
a
J
J
J
J
J
w
w
w
w
w
w
w
w
w
w
w
J
J
a
"}
(17,1,1) = {"
a
J
J
J
J
w
w
w
w
w
w
w
w
w
w
w
w
J
J
a
"}
(18,1,1) = {"
a
J
J
J
w
w
w
w
w
w
w
w
w
w
w
w
J
J
J
a
"}
(19,1,1) = {"
a
J
J
J
J
J
J
w
w
w
w
w
w
J
J
J
J
J
J
a
"}
(20,1,1) = {"
a
a
a
a
a
a
a
a
a
a
a
a
a
a
a
a
a
a
a
a
"}
