//MAP CONVERTED BY dmm2tgm.py THIS HEADER COMMENT PREVENTS RECONVERSION, DO NOT REMOVE
"a" = (
/turf/simulated/mineral/floor/ignore_cavegen/turfpack/muriki,
/area/mine/unexplored/muriki/cave/deepdark)
"B" = (
/turf/template_noop,
/area/mine/unexplored/muriki/cave/deepdark)
"H" = (
/turf/template_noop,
/area/template_noop)

(1,1,1) = {"
H
H
H
H
H
H
H
H
H
H
H
H
H
H
H
H
H
H
H
H
"}
(2,1,1) = {"
H
B
B
B
B
B
B
B
B
B
B
a
a
a
B
B
B
B
B
H
"}
(3,1,1) = {"
H
B
B
B
B
B
a
a
a
a
a
a
a
a
a
B
B
B
B
H
"}
(4,1,1) = {"
H
B
B
B
a
a
a
a
a
a
a
a
a
a
a
a
B
B
B
H
"}
(5,1,1) = {"
H
B
B
a
a
a
a
a
a
a
a
a
a
a
a
a
B
B
B
H
"}
(6,1,1) = {"
H
B
B
a
a
a
a
a
a
a
a
a
a
a
a
a
a
B
B
H
"}
(7,1,1) = {"
H
B
B
a
a
a
a
a
a
a
a
a
a
a
a
a
a
a
B
H
"}
(8,1,1) = {"
H
B
B
a
a
a
a
a
a
a
a
a
a
a
a
a
a
a
B
H
"}
(9,1,1) = {"
H
B
B
B
a
a
a
a
a
a
a
a
a
a
a
a
a
a
B
H
"}
(10,1,1) = {"
H
B
B
B
a
a
a
a
a
a
a
B
B
B
a
a
a
a
a
H
"}
(11,1,1) = {"
H
B
B
B
a
a
a
a
a
a
B
B
B
B
B
a
a
a
a
H
"}
(12,1,1) = {"
H
B
B
a
a
a
a
a
a
a
B
B
B
B
B
B
a
a
a
H
"}
(13,1,1) = {"
H
B
B
a
a
a
a
a
a
a
B
B
B
B
B
B
B
B
B
H
"}
(14,1,1) = {"
H
B
B
B
a
a
a
a
a
a
a
a
B
B
B
B
B
B
B
H
"}
(15,1,1) = {"
H
B
B
B
B
a
a
a
a
a
a
a
a
a
B
B
B
B
B
H
"}
(16,1,1) = {"
H
B
B
B
B
B
a
a
a
a
a
a
a
a
a
a
B
B
B
H
"}
(17,1,1) = {"
H
B
B
B
B
B
a
a
a
a
a
a
a
a
a
a
B
B
B
H
"}
(18,1,1) = {"
H
B
B
B
B
B
B
a
a
a
a
a
a
a
a
B
B
B
B
H
"}
(19,1,1) = {"
H
B
B
B
B
B
B
B
B
a
a
a
a
B
B
B
B
B
B
H
"}
(20,1,1) = {"
H
H
H
H
H
H
H
H
H
H
H
H
H
H
H
H
H
H
H
H
"}
