//MAP CONVERTED BY dmm2tgm.py THIS HEADER COMMENT PREVENTS RECONVERSION, DO NOT REMOVE
"a" = (
/turf/simulated/mineral/alt/ignore_mapgen/turfpack/muriki,
/area/mine/explored/muriki/cave/deepdark)
"d" = (
/obj/structure/cliff/corner{
	dir = 6
	},
/turf/simulated/mineral/floor/ignore_cavegen/turfpack/muriki,
/area/mine/explored/muriki/cave/deepdark)
"e" = (
/turf/template_noop,
/area/mine/unexplored/muriki/cave/deepdark)
"i" = (
/turf/template_noop,
/area/template_noop)
"j" = (
/obj/structure/cliff/corner{
	dir = 10
	},
/turf/simulated/mineral/floor/ignore_cavegen/turfpack/muriki,
/area/mine/explored/muriki/cave/deepdark)
"p" = (
/obj/structure/cliff{
	dir = 8
	},
/turf/simulated/mineral/floor/ignore_cavegen/turfpack/muriki,
/area/mine/explored/muriki/cave/deepdark)
"D" = (
/turf/simulated/mineral/alt/ignore_mapgen/turfpack/muriki,
/area/mine/unexplored/muriki/cave/deepdark)
"E" = (
/turf/template_noop,
/area/mine/explored/muriki/cave/deepdark)
"H" = (
/obj/structure/cliff_end{
	dir = 1
	},
/turf/simulated/mineral/floor/ignore_cavegen/turfpack/muriki,
/area/mine/explored/muriki/cave/deepdark)
"I" = (
/obj/effect/landmark/step_trap,
/turf/simulated/mineral/floor/ignore_cavegen/turfpack/muriki,
/area/mine/explored/muriki/cave/deepdark)
"J" = (
/obj/structure/cliff_end{
	dir = 4
	},
/turf/simulated/mineral/floor/ignore_cavegen/turfpack/muriki,
/area/mine/explored/muriki/cave/deepdark)
"K" = (
/turf/simulated/mineral/floor/ignore_cavegen/turfpack/muriki,
/area/mine/explored/muriki/cave/deepdark)
"L" = (
/obj/structure/cliff,
/turf/simulated/mineral/floor/ignore_cavegen/turfpack/muriki,
/area/mine/explored/muriki/cave/deepdark)
"M" = (
/obj/structure/cliff{
	dir = 10
	},
/turf/simulated/mineral/floor/ignore_cavegen/turfpack/muriki,
/area/mine/explored/muriki/cave/deepdark)
"Q" = (
/obj/structure/cliff{
	dir = 6
	},
/turf/simulated/mineral/floor/ignore_cavegen/turfpack/muriki,
/area/mine/explored/muriki/cave/deepdark)
"R" = (
/obj/structure/cliff_end{
	dir = 1
	},
/turf/simulated/mineral/alt/ignore_mapgen/turfpack/muriki,
/area/mine/explored/muriki/cave/deepdark)
"V" = (
/obj/structure/cliff_end{
	dir = 8
	},
/turf/simulated/mineral/floor/ignore_cavegen/turfpack/muriki,
/area/mine/explored/muriki/cave/deepdark)
"Z" = (
/obj/structure/cliff{
	dir = 4
	},
/turf/simulated/mineral/floor/ignore_cavegen/turfpack/muriki,
/area/mine/explored/muriki/cave/deepdark)

(1,1,1) = {"
i
i
i
i
i
i
i
i
i
i
i
i
i
i
i
i
i
i
i
i
i
i
i
i
i
i
i
i
i
i
"}
(2,1,1) = {"
i
e
e
e
e
e
e
e
e
e
e
e
e
e
e
e
e
e
e
D
D
D
D
D
e
e
e
e
e
i
"}
(3,1,1) = {"
i
e
e
e
e
e
e
e
e
e
e
e
e
e
e
e
e
e
E
a
a
a
a
a
a
a
e
e
e
i
"}
(4,1,1) = {"
i
e
e
e
e
e
e
e
e
e
e
e
E
E
E
E
E
E
a
a
a
a
a
a
a
a
D
e
e
i
"}
(5,1,1) = {"
i
e
e
e
e
e
e
e
e
K
K
K
K
K
K
K
K
K
a
a
a
a
a
a
a
a
D
e
e
i
"}
(6,1,1) = {"
i
e
e
e
E
E
K
K
K
K
K
K
K
Q
Z
Z
Z
Z
a
a
a
a
a
a
a
a
D
e
e
i
"}
(7,1,1) = {"
i
e
e
e
K
K
K
K
K
Q
Z
Z
Z
d
K
K
K
K
a
a
a
a
a
a
a
a
D
e
e
i
"}
(8,1,1) = {"
i
e
e
E
K
K
K
K
K
L
Q
Z
Z
Z
Z
Z
H
K
K
K
K
a
a
a
a
a
e
e
e
i
"}
(9,1,1) = {"
i
e
e
E
K
K
K
K
Q
d
L
K
K
K
K
K
K
K
K
K
K
E
E
e
e
e
e
e
e
i
"}
(10,1,1) = {"
i
e
e
E
E
K
K
K
L
K
L
a
a
a
K
K
I
K
K
K
E
E
E
e
e
e
e
e
e
i
"}
(11,1,1) = {"
i
e
e
E
K
K
K
K
L
K
L
a
a
a
a
K
K
E
E
E
E
e
e
e
e
e
e
e
e
i
"}
(12,1,1) = {"
i
e
e
E
K
K
K
Q
d
K
V
a
a
a
a
K
K
E
E
E
E
e
e
e
e
e
e
e
e
i
"}
(13,1,1) = {"
i
e
e
E
K
K
K
L
K
K
K
K
K
L
K
K
K
K
E
E
E
e
e
e
e
e
e
e
e
i
"}
(14,1,1) = {"
i
e
e
E
E
K
K
L
K
K
K
K
K
L
Q
Z
H
K
E
E
E
e
e
e
e
e
e
e
e
i
"}
(15,1,1) = {"
i
e
e
E
E
K
K
L
K
I
K
K
K
L
L
K
K
K
E
E
E
e
e
e
e
e
e
e
e
i
"}
(16,1,1) = {"
i
e
e
E
E
K
K
L
K
K
J
K
K
a
a
a
a
K
K
K
E
e
e
e
e
e
e
e
e
i
"}
(17,1,1) = {"
i
e
e
E
E
K
K
L
K
K
L
K
K
a
a
a
a
a
K
K
E
e
e
e
e
e
e
e
e
i
"}
(18,1,1) = {"
i
e
e
e
E
K
K
L
K
K
L
K
K
a
a
a
a
a
K
E
E
e
e
e
e
e
e
e
e
i
"}
(19,1,1) = {"
i
e
e
e
E
E
K
M
p
j
M
p
p
p
R
a
a
a
K
E
E
E
E
e
e
e
e
e
e
i
"}
(20,1,1) = {"
i
e
e
e
e
E
K
K
K
M
j
K
K
K
K
K
K
K
K
K
K
E
E
E
e
e
e
e
e
i
"}
(21,1,1) = {"
i
e
e
e
e
E
E
K
K
K
L
K
K
K
K
K
K
K
K
K
K
K
K
E
E
E
E
e
e
i
"}
(22,1,1) = {"
i
e
e
e
e
e
E
K
K
K
L
K
K
K
K
K
I
K
a
a
a
a
a
a
a
E
E
e
e
i
"}
(23,1,1) = {"
i
e
e
e
e
e
E
E
E
K
M
p
p
j
K
K
K
K
a
a
a
a
a
a
a
a
E
e
e
i
"}
(24,1,1) = {"
i
e
e
e
e
e
e
e
E
K
K
K
K
M
p
p
p
p
a
a
a
a
a
a
a
a
a
e
e
i
"}
(25,1,1) = {"
i
e
e
e
e
e
e
e
e
E
E
E
K
K
K
K
K
K
a
a
a
a
a
a
a
a
D
e
e
i
"}
(26,1,1) = {"
i
e
e
e
e
e
e
e
e
e
E
E
E
E
E
E
E
E
E
a
a
a
a
a
a
a
D
e
e
i
"}
(27,1,1) = {"
i
e
e
e
e
e
e
e
e
e
e
e
e
e
e
e
e
e
E
E
a
a
a
a
a
a
e
e
e
i
"}
(28,1,1) = {"
i
e
e
e
e
e
e
e
e
e
e
e
e
e
e
e
e
e
e
e
e
e
e
D
D
e
e
e
e
i
"}
(29,1,1) = {"
i
e
e
e
e
e
e
e
e
e
e
e
e
e
e
e
e
e
e
e
e
e
e
e
e
e
e
e
e
i
"}
(30,1,1) = {"
i
i
i
i
i
i
i
i
i
i
i
i
i
i
i
i
i
i
i
i
i
i
i
i
i
i
i
i
i
i
"}
