//MAP CONVERTED BY dmm2tgm.py THIS HEADER COMMENT PREVENTS RECONVERSION, DO NOT REMOVE
"a" = (
/turf/simulated/mineral/alt/ignore_mapgen/turfpack/muriki,
/area/mine/explored/muriki/cave/deepdark)
"b" = (
/obj/structure/cliff{
	dir = 1
	},
/turf/simulated/mineral/floor/ignore_cavegen/turfpack/muriki,
/area/mine/unexplored/muriki/cave/deepdark)
"c" = (
/obj/structure/cliff_end{
	dir = 8
	},
/turf/simulated/mineral/floor/ignore_cavegen/turfpack/muriki,
/area/mine/explored/muriki/cave/deepdark)
"e" = (
/obj/structure/cliff_end,
/turf/simulated/mineral/floor/ignore_cavegen/turfpack/muriki,
/area/mine/unexplored/muriki/cave/deepdark)
"f" = (
/turf/simulated/mineral/floor/ignore_cavegen/turfpack/muriki,
/area/mine/explored/muriki/cave/deepdark)
"g" = (
/obj/structure/cliff{
	dir = 6
	},
/turf/simulated/mineral/floor/ignore_cavegen/turfpack/muriki,
/area/mine/explored/muriki/cave/deepdark)
"h" = (
/turf/simulated/mineral/alt/ignore_mapgen/turfpack/muriki,
/area/mine/unexplored/muriki/cave/deepdark)
"l" = (
/obj/structure/cliff,
/turf/simulated/mineral/floor/ignore_cavegen/turfpack/muriki,
/area/mine/explored/muriki/cave/deepdark)
"o" = (
/obj/structure/cliff{
	dir = 5
	},
/turf/simulated/mineral/floor/ignore_cavegen/turfpack/muriki,
/area/mine/explored/muriki/cave/deepdark)
"p" = (
/obj/effect/landmark/step_trap,
/turf/simulated/mineral/floor/ignore_cavegen/turfpack/muriki,
/area/mine/explored/muriki/cave/deepdark)
"u" = (
/obj/structure/cliff{
	dir = 9
	},
/turf/simulated/mineral/floor/ignore_cavegen/turfpack/muriki,
/area/mine/explored/muriki/cave/deepdark)
"v" = (
/obj/structure/cliff/corner{
	dir = 5
	},
/turf/simulated/mineral/floor/ignore_cavegen/turfpack/muriki,
/area/mine/explored/muriki/cave/deepdark)
"w" = (
/turf/template_noop,
/area/template_noop)
"x" = (
/turf/template_noop,
/area/mine/explored/muriki/cave/deepdark)
"A" = (
/obj/structure/cliff_end{
	dir = 1
	},
/turf/simulated/mineral/floor/ignore_cavegen/turfpack/muriki,
/area/mine/explored/muriki/cave/deepdark)
"D" = (
/obj/structure/cliff{
	dir = 1
	},
/turf/simulated/mineral/floor/ignore_cavegen/turfpack/muriki,
/area/mine/explored/muriki/cave/deepdark)
"E" = (
/obj/structure/cliff{
	dir = 8
	},
/turf/simulated/mineral/floor/ignore_cavegen/turfpack/muriki,
/area/mine/explored/muriki/cave/deepdark)
"F" = (
/obj/structure/cliff/corner{
	dir = 9
	},
/turf/simulated/mineral/floor/ignore_cavegen/turfpack/muriki,
/area/mine/explored/muriki/cave/deepdark)
"G" = (
/obj/structure/cliff{
	dir = 4
	},
/turf/simulated/mineral/floor/ignore_cavegen/turfpack/muriki,
/area/mine/explored/muriki/cave/deepdark)
"J" = (
/obj/structure/cliff{
	dir = 10
	},
/turf/simulated/mineral/floor/ignore_cavegen/turfpack/muriki,
/area/mine/explored/muriki/cave/deepdark)
"K" = (
/obj/structure/cliff_end{
	dir = 4
	},
/turf/simulated/mineral/floor/ignore_cavegen/turfpack/muriki,
/area/mine/explored/muriki/cave/deepdark)
"M" = (
/obj/structure/cliff_end,
/turf/simulated/mineral/floor/ignore_cavegen/turfpack/muriki,
/area/mine/explored/muriki/cave/deepdark)
"O" = (
/obj/structure/cliff/corner{
	dir = 6
	},
/turf/simulated/mineral/floor/ignore_cavegen/turfpack/muriki,
/area/mine/explored/muriki/cave/deepdark)
"P" = (
/turf/template_noop,
/area/mine/unexplored/muriki/cave/deepdark)
"V" = (
/turf/simulated/mineral/floor/ignore_cavegen/turfpack/muriki,
/area/mine/unexplored/muriki/cave/deepdark)
"Z" = (
/obj/structure/cliff/corner{
	dir = 10
	},
/turf/simulated/mineral/floor/ignore_cavegen/turfpack/muriki,
/area/mine/explored/muriki/cave/deepdark)

(1,1,1) = {"
w
w
w
w
w
w
w
w
w
w
w
w
w
w
w
w
w
w
w
w
w
w
w
w
w
w
w
w
w
w
w
w
w
w
w
"}
(2,1,1) = {"
w
P
P
P
P
P
P
P
P
P
P
P
P
P
P
P
P
P
P
P
P
P
P
P
P
P
P
P
P
P
P
P
P
P
w
"}
(3,1,1) = {"
w
P
P
P
P
P
P
P
P
P
h
h
h
a
x
x
x
x
x
x
x
P
P
P
P
P
P
P
P
P
P
P
P
P
w
"}
(4,1,1) = {"
w
P
P
P
P
P
P
P
P
x
a
a
a
a
a
f
f
f
f
x
x
x
x
x
P
P
h
h
h
h
h
P
P
P
w
"}
(5,1,1) = {"
w
P
P
P
P
P
P
P
P
a
a
a
a
a
a
f
f
f
f
K
f
f
f
f
x
a
a
a
a
h
h
P
P
P
w
"}
(6,1,1) = {"
w
P
P
P
P
x
f
f
f
a
a
a
a
a
a
f
f
f
f
l
f
f
f
f
p
a
a
a
a
a
a
a
P
P
w
"}
(7,1,1) = {"
w
P
P
P
P
f
f
p
f
a
a
a
a
F
E
E
E
E
Z
J
E
E
E
E
E
a
a
a
a
a
a
a
P
P
w
"}
(8,1,1) = {"
w
P
P
f
f
F
E
E
E
E
E
A
f
D
f
f
f
p
J
E
E
E
E
Z
f
f
a
a
a
a
a
a
P
P
w
"}
(9,1,1) = {"
w
P
P
f
f
D
f
F
E
E
E
E
E
u
f
f
f
f
f
f
f
f
f
J
E
E
Z
l
a
a
a
a
V
P
w
"}
(10,1,1) = {"
w
P
P
f
f
D
F
u
f
f
f
f
f
f
f
f
P
P
P
P
P
x
f
f
f
f
l
J
E
E
Z
f
f
P
w
"}
(11,1,1) = {"
w
P
P
f
f
D
D
f
f
f
x
x
x
P
P
P
P
P
P
P
P
P
V
f
f
f
J
E
E
Z
l
p
f
P
w
"}
(12,1,1) = {"
w
P
x
f
f
D
D
f
f
V
P
P
P
P
P
P
P
P
P
P
P
P
P
x
x
f
f
f
f
l
l
f
x
P
w
"}
(13,1,1) = {"
w
V
f
f
f
D
D
f
f
P
P
P
P
P
P
P
P
P
P
P
P
P
P
P
P
P
f
f
f
l
l
f
x
P
w
"}
(14,1,1) = {"
w
h
a
f
f
D
D
f
P
P
P
P
P
P
P
P
P
P
P
P
P
P
P
P
P
P
x
f
f
l
l
f
x
P
w
"}
(15,1,1) = {"
w
h
a
a
f
D
D
f
P
P
P
P
P
P
P
P
P
P
P
P
P
P
P
P
P
P
x
f
p
l
l
f
x
P
w
"}
(16,1,1) = {"
w
a
a
a
E
u
D
f
V
P
P
P
P
P
P
P
P
P
P
P
P
P
P
P
P
P
x
f
f
l
a
a
a
P
w
"}
(17,1,1) = {"
w
a
a
a
f
f
v
o
V
P
P
P
P
P
P
P
P
P
P
P
P
P
P
P
P
P
x
f
f
c
a
a
a
h
w
"}
(18,1,1) = {"
w
f
f
D
f
f
f
D
V
P
P
P
P
P
P
P
P
P
P
P
P
P
P
P
P
P
P
V
f
f
a
a
a
h
w
"}
(19,1,1) = {"
w
f
f
v
o
f
f
D
V
P
P
P
P
P
P
P
P
P
P
P
P
P
P
P
P
P
P
V
f
f
a
a
a
h
w
"}
(20,1,1) = {"
w
f
f
f
D
f
p
D
V
P
P
P
P
P
P
P
P
P
P
P
P
P
P
P
P
P
P
x
f
f
l
a
a
h
w
"}
(21,1,1) = {"
w
a
a
a
D
f
f
b
V
P
P
P
P
P
P
P
P
P
P
P
P
P
P
P
P
P
P
x
f
p
l
f
f
P
w
"}
(22,1,1) = {"
w
a
a
a
D
f
f
D
f
P
P
P
P
P
P
P
P
P
P
P
P
P
P
P
P
P
P
f
f
f
l
f
f
P
w
"}
(23,1,1) = {"
w
a
a
a
a
f
f
D
f
P
P
P
P
P
P
P
P
P
P
P
P
P
P
P
P
P
P
f
g
G
O
f
V
P
w
"}
(24,1,1) = {"
w
h
a
a
a
E
E
u
f
f
V
P
P
P
P
P
P
P
P
P
P
P
P
P
P
x
x
f
l
g
G
A
V
P
w
"}
(25,1,1) = {"
w
h
a
a
a
f
f
f
f
f
f
x
x
x
x
P
P
P
P
P
P
P
P
P
V
f
f
f
l
l
f
f
V
P
w
"}
(26,1,1) = {"
w
P
a
a
a
G
G
G
G
o
f
x
x
x
x
P
P
P
P
P
x
f
f
f
f
M
G
G
O
l
f
f
P
P
w
"}
(27,1,1) = {"
w
P
P
e
G
G
G
G
o
D
f
f
f
f
f
f
f
x
f
f
f
f
f
p
f
a
a
a
a
l
f
x
P
P
w
"}
(28,1,1) = {"
w
P
P
P
f
f
f
f
D
a
a
a
G
G
G
o
f
f
f
f
g
G
G
G
a
a
a
a
a
a
f
x
P
P
w
"}
(29,1,1) = {"
w
P
P
P
f
f
f
a
a
a
a
a
p
f
f
v
G
G
G
G
O
f
f
f
a
a
a
a
a
a
x
x
P
P
w
"}
(30,1,1) = {"
w
P
P
P
f
f
a
a
a
a
a
a
f
f
g
G
G
G
G
G
G
G
A
f
a
a
a
a
a
a
x
x
P
P
w
"}
(31,1,1) = {"
w
P
P
P
P
P
h
h
a
a
a
a
f
f
l
f
f
f
f
p
f
f
f
f
a
a
a
a
x
x
P
P
P
P
w
"}
(32,1,1) = {"
w
P
P
P
P
P
h
h
a
a
a
f
f
f
c
f
f
f
f
f
f
x
x
x
x
x
x
P
P
P
P
P
P
P
w
"}
(33,1,1) = {"
w
P
P
P
P
P
P
h
a
a
a
x
x
x
x
P
P
x
x
x
x
x
x
x
x
P
P
P
P
P
P
P
P
P
w
"}
(34,1,1) = {"
w
P
P
P
P
P
P
P
P
P
P
P
P
P
P
P
P
P
P
P
P
P
P
P
P
P
P
P
P
P
P
P
P
P
w
"}
(35,1,1) = {"
w
w
w
w
w
w
w
w
w
w
w
w
w
w
w
w
w
w
w
w
w
w
w
w
w
w
w
w
w
w
w
w
w
w
w
"}
