//MAP CONVERTED BY dmm2tgm.py THIS HEADER COMMENT PREVENTS RECONVERSION, DO NOT REMOVE
"a" = (
/turf/template_noop,
/area/mine/unexplored/muriki/cave/deepdark)
"e" = (
/obj/structure/cliff_end{
	dir = 4
	},
/turf/simulated/mineral/floor/ignore_cavegen/turfpack/muriki,
/area/mine/explored/muriki/cave/deepdark)
"i" = (
/turf/template_noop,
/area/template_noop)
"j" = (
/obj/structure/cliff{
	dir = 8
	},
/turf/simulated/mineral/floor/ignore_cavegen/turfpack/muriki,
/area/mine/explored/muriki/cave/deepdark)
"n" = (
/turf/simulated/mineral/floor/ignore_cavegen/turfpack/muriki,
/area/mine/explored/muriki/cave/deepdark)
"o" = (
/obj/structure/cliff{
	dir = 10
	},
/turf/simulated/mineral/floor/ignore_cavegen/turfpack/muriki,
/area/mine/explored/muriki/cave/deepdark)
"y" = (
/turf/simulated/mineral/alt/ignore_mapgen/turfpack/muriki,
/area/mine/unexplored/muriki/cave/deepdark)
"B" = (
/obj/structure/cliff,
/turf/simulated/mineral/floor/ignore_cavegen/turfpack/muriki,
/area/mine/explored/muriki/cave/deepdark)
"K" = (
/turf/template_noop,
/area/mine/explored/muriki/cave/deepdark)
"P" = (
/obj/effect/landmark/step_trap,
/turf/simulated/mineral/floor/ignore_cavegen/turfpack/muriki,
/area/mine/explored/muriki/cave/deepdark)
"S" = (
/obj/structure/cliff/corner{
	dir = 10
	},
/turf/simulated/mineral/floor/ignore_cavegen/turfpack/muriki,
/area/mine/explored/muriki/cave/deepdark)
"T" = (
/obj/structure/cliff_end{
	dir = 1
	},
/turf/simulated/mineral/floor/ignore_cavegen/turfpack/muriki,
/area/mine/explored/muriki/cave/deepdark)
"U" = (
/turf/simulated/mineral/alt/ignore_mapgen/turfpack/muriki,
/area/mine/explored/muriki/cave/deepdark)

(1,1,1) = {"
i
i
i
i
i
i
i
i
i
i
i
i
i
i
i
i
i
i
i
i
i
i
i
i
i
i
i
i
i
i
"}
(2,1,1) = {"
i
a
a
a
a
a
a
a
a
a
a
a
a
a
a
a
a
a
a
a
a
a
a
a
a
a
a
a
a
i
"}
(3,1,1) = {"
i
a
a
a
a
a
a
a
a
a
a
a
a
a
a
a
a
a
a
a
a
a
a
a
a
a
a
a
a
i
"}
(4,1,1) = {"
i
a
a
a
a
a
a
a
a
a
a
a
a
a
a
a
a
a
a
a
a
a
a
a
a
a
a
a
a
i
"}
(5,1,1) = {"
i
a
a
y
y
a
a
a
a
a
a
a
a
a
a
a
a
a
a
a
a
a
a
a
a
a
a
a
a
i
"}
(6,1,1) = {"
i
K
K
U
U
K
K
K
n
n
a
a
a
a
a
a
a
a
a
a
a
a
a
a
a
a
a
a
a
i
"}
(7,1,1) = {"
i
K
U
U
U
U
K
n
n
U
U
K
a
a
a
a
a
a
a
a
a
a
a
a
a
a
a
a
a
i
"}
(8,1,1) = {"
i
U
U
U
U
U
n
P
U
U
U
K
K
a
a
a
a
a
a
a
a
a
a
a
a
a
a
a
a
i
"}
(9,1,1) = {"
i
U
U
U
U
n
n
n
e
n
n
n
K
a
a
a
a
a
a
a
a
a
a
a
a
a
a
a
a
i
"}
(10,1,1) = {"
i
U
U
U
U
j
j
S
o
j
j
T
K
K
K
K
K
a
a
a
a
a
a
a
a
a
a
a
a
i
"}
(11,1,1) = {"
i
U
U
U
U
n
n
o
j
S
n
n
n
n
n
K
K
K
K
a
a
a
a
a
a
a
a
a
a
i
"}
(12,1,1) = {"
i
a
U
U
K
K
n
n
n
o
j
S
n
P
n
e
n
n
K
K
K
K
a
a
a
a
a
a
a
i
"}
(13,1,1) = {"
i
a
U
U
K
K
a
a
n
n
n
o
S
n
n
B
n
n
n
n
n
n
n
a
a
a
a
a
a
i
"}
(14,1,1) = {"
i
a
a
a
a
a
a
a
K
n
n
n
o
j
S
o
j
j
j
j
j
j
T
n
U
U
K
a
a
i
"}
(15,1,1) = {"
i
a
a
a
a
a
a
a
a
a
n
n
n
n
o
j
j
j
j
j
S
n
n
n
U
U
n
a
a
i
"}
(16,1,1) = {"
i
a
a
a
a
a
a
a
a
a
K
K
K
n
n
n
n
n
n
n
o
S
n
n
U
n
n
a
a
i
"}
(17,1,1) = {"
i
a
a
a
a
a
a
a
a
a
a
a
K
K
K
K
n
n
n
n
n
o
S
n
n
n
K
K
a
i
"}
(18,1,1) = {"
i
a
a
a
a
a
a
a
a
a
a
a
a
a
K
K
K
K
K
K
n
P
B
n
n
n
K
K
a
i
"}
(19,1,1) = {"
i
a
a
a
a
a
a
a
a
a
a
a
a
a
a
a
a
K
K
K
K
n
B
n
n
K
K
K
a
i
"}
(20,1,1) = {"
i
a
a
a
a
a
a
a
a
a
a
a
a
a
a
a
a
K
K
K
K
n
o
S
n
n
K
a
a
i
"}
(21,1,1) = {"
i
a
a
a
a
a
a
a
a
a
a
a
a
a
a
a
a
a
a
K
K
n
n
B
U
U
U
y
a
i
"}
(22,1,1) = {"
i
a
a
a
a
a
a
a
a
a
a
a
a
a
a
a
a
a
a
K
K
n
U
U
U
U
U
y
a
i
"}
(23,1,1) = {"
i
a
a
a
a
a
a
a
a
a
a
a
a
a
a
a
a
a
a
K
K
U
U
U
U
U
U
y
a
i
"}
(24,1,1) = {"
i
a
a
a
a
a
a
a
a
a
a
a
a
a
a
a
a
a
a
K
K
U
U
U
U
U
U
a
a
i
"}
(25,1,1) = {"
i
a
a
a
a
a
a
a
a
a
a
a
a
a
a
a
a
a
a
a
a
a
K
K
U
U
a
a
a
i
"}
(26,1,1) = {"
i
a
a
a
a
a
a
a
a
a
a
a
a
a
a
a
a
a
a
a
a
a
a
a
a
a
a
a
a
i
"}
(27,1,1) = {"
i
a
a
a
a
a
a
a
a
a
a
a
a
a
a
a
a
a
a
a
a
a
a
a
a
a
a
a
a
i
"}
(28,1,1) = {"
i
a
a
a
a
a
a
a
a
a
a
a
a
a
a
a
a
a
a
a
a
a
a
a
a
a
a
a
a
i
"}
(29,1,1) = {"
i
a
a
a
a
a
a
a
a
a
a
a
a
a
a
a
a
a
a
a
a
a
a
a
a
a
a
a
a
i
"}
(30,1,1) = {"
i
i
i
i
i
i
i
i
i
i
i
i
i
i
i
i
i
i
i
i
i
i
i
i
i
i
i
i
i
i
"}
