//MAP CONVERTED BY dmm2tgm.py THIS HEADER COMMENT PREVENTS RECONVERSION, DO NOT REMOVE
"a" = (
/turf/simulated/mineral/alt/ignore_mapgen/turfpack/muriki,
/area/mine/explored/muriki/cave/deepdark)
"f" = (
/turf/simulated/mineral/alt/ignore_mapgen/turfpack/muriki,
/area/mine/unexplored/muriki/cave/deepdark)
"g" = (
/obj/effect/landmark/step_trap,
/turf/simulated/mineral/floor/ignore_cavegen/turfpack/muriki,
/area/mine/explored/muriki/cave/deepdark)
"k" = (
/turf/simulated/mineral/floor/ignore_cavegen/turfpack/muriki,
/area/mine/unexplored/muriki/cave/deepdark)
"m" = (
/obj/structure/cliff/corner{
	dir = 5
	},
/turf/simulated/mineral/floor/ignore_cavegen/turfpack/muriki,
/area/mine/explored/muriki/cave/deepdark)
"r" = (
/turf/simulated/mineral/floor/ignore_cavegen/turfpack/muriki,
/area/mine/explored/muriki/cave/deepdark)
"t" = (
/turf/template_noop,
/area/mine/unexplored/muriki/cave/deepdark)
"u" = (
/turf/template_noop,
/area/template_noop)
"B" = (
/obj/structure/cliff{
	dir = 1
	},
/turf/simulated/mineral/floor/ignore_cavegen/turfpack/muriki,
/area/mine/explored/muriki/cave/deepdark)
"F" = (
/obj/structure/cliff_end{
	dir = 8
	},
/turf/simulated/mineral/floor/ignore_cavegen/turfpack/muriki,
/area/mine/explored/muriki/cave/deepdark)
"M" = (
/obj/structure/cliff{
	dir = 5
	},
/turf/simulated/mineral/floor/ignore_cavegen/turfpack/muriki,
/area/mine/explored/muriki/cave/deepdark)
"O" = (
/obj/structure/cliff{
	dir = 4
	},
/turf/simulated/mineral/floor/ignore_cavegen/turfpack/muriki,
/area/mine/explored/muriki/cave/deepdark)
"P" = (
/obj/structure/cliff_end,
/turf/simulated/mineral/floor/ignore_cavegen/turfpack/muriki,
/area/mine/explored/muriki/cave/deepdark)
"Y" = (
/turf/template_noop,
/area/mine/explored/muriki/cave/deepdark)

(1,1,1) = {"
u
u
u
u
u
u
u
u
u
u
u
u
u
u
u
u
u
u
u
u
u
u
u
u
u
u
u
u
u
u
u
u
u
u
u
u
u
u
u
u
"}
(2,1,1) = {"
u
t
t
t
t
t
t
t
t
t
t
t
t
t
t
t
t
t
t
t
t
t
t
t
t
t
t
t
t
t
t
t
t
t
t
t
t
t
t
u
"}
(3,1,1) = {"
u
t
t
t
t
t
t
t
t
t
t
t
t
t
t
t
t
t
t
t
t
t
t
t
t
t
t
t
t
t
t
t
t
t
t
t
t
t
t
u
"}
(4,1,1) = {"
u
t
t
t
t
t
t
t
t
t
t
t
t
t
t
t
t
t
t
t
t
t
t
t
t
t
t
t
t
t
t
t
t
t
t
t
t
t
t
u
"}
(5,1,1) = {"
u
t
t
f
f
t
t
t
t
t
t
t
t
t
t
t
t
t
t
t
t
t
t
t
t
t
t
t
t
t
t
t
t
t
t
t
t
t
t
u
"}
(6,1,1) = {"
u
t
t
f
f
t
t
t
t
t
t
t
t
t
t
t
t
t
t
t
t
t
t
t
t
t
t
t
t
t
t
t
t
t
t
t
t
t
t
u
"}
(7,1,1) = {"
u
t
a
a
a
a
Y
t
t
t
t
t
t
t
t
t
t
t
t
t
t
t
t
t
t
t
t
t
t
t
t
t
t
t
t
t
t
t
t
u
"}
(8,1,1) = {"
u
f
a
a
a
a
Y
t
t
t
t
t
t
t
t
t
t
t
t
t
t
t
t
t
t
t
t
t
t
t
t
t
t
t
t
t
t
t
t
u
"}
(9,1,1) = {"
u
f
a
a
a
a
r
r
r
r
k
t
t
t
t
t
t
t
t
t
t
t
t
t
t
t
t
t
t
t
t
t
t
t
t
t
t
t
t
u
"}
(10,1,1) = {"
u
f
a
a
a
a
r
r
r
r
k
k
t
t
t
t
t
t
t
t
t
t
t
t
t
t
t
t
t
t
t
t
t
t
t
t
t
t
t
u
"}
(11,1,1) = {"
u
f
a
a
a
a
O
O
O
O
M
r
Y
Y
Y
Y
Y
t
t
t
t
t
t
t
t
t
t
t
t
t
t
t
t
t
t
t
t
t
t
u
"}
(12,1,1) = {"
u
t
a
a
a
r
r
r
r
r
B
r
r
r
r
r
Y
t
t
t
t
t
t
t
t
t
t
t
t
t
t
t
t
t
t
t
t
t
t
u
"}
(13,1,1) = {"
u
t
f
a
a
r
r
r
r
r
m
M
r
r
r
r
r
r
r
r
t
t
t
t
t
t
t
t
t
t
t
t
t
t
t
t
t
t
t
u
"}
(14,1,1) = {"
u
t
t
Y
Y
r
r
r
r
r
r
m
O
O
O
O
M
r
r
r
r
Y
Y
t
t
t
t
t
t
t
t
t
t
t
t
t
t
t
t
u
"}
(15,1,1) = {"
u
t
t
Y
Y
r
r
P
O
O
O
O
O
O
O
M
m
O
M
r
r
Y
Y
t
t
t
t
t
t
t
t
t
t
t
t
t
t
t
t
u
"}
(16,1,1) = {"
u
t
t
Y
Y
Y
Y
r
r
r
r
r
r
r
r
B
r
r
B
r
r
r
r
r
r
t
t
t
t
t
t
t
t
t
t
t
t
t
t
u
"}
(17,1,1) = {"
u
t
t
t
t
t
Y
Y
Y
r
r
a
a
r
r
F
g
r
m
M
r
r
r
r
r
Y
Y
Y
t
t
t
t
t
t
t
t
t
t
t
u
"}
(18,1,1) = {"
u
t
t
t
t
t
Y
Y
Y
r
a
a
a
a
r
r
r
r
r
m
O
O
O
M
r
r
r
Y
Y
Y
Y
t
t
t
t
t
t
t
t
u
"}
(19,1,1) = {"
u
t
t
t
t
t
t
t
t
t
t
a
a
a
r
r
r
P
O
O
O
O
M
B
r
r
r
Y
Y
Y
Y
t
t
t
t
t
t
t
t
u
"}
(20,1,1) = {"
u
t
t
t
t
t
t
t
t
t
t
Y
Y
Y
Y
Y
Y
r
r
r
r
r
B
m
M
g
r
r
r
r
Y
t
t
t
t
t
t
t
t
u
"}
(21,1,1) = {"
u
t
t
t
t
t
t
t
t
t
t
t
t
Y
Y
Y
Y
r
r
r
r
r
B
r
m
O
O
O
M
r
r
Y
Y
t
t
t
t
t
t
u
"}
(22,1,1) = {"
u
t
t
t
t
t
t
t
t
t
t
t
t
Y
Y
Y
Y
Y
Y
r
r
r
F
r
r
r
r
r
B
r
r
r
Y
t
t
t
t
t
t
u
"}
(23,1,1) = {"
u
t
t
t
t
t
t
t
t
t
t
t
t
t
t
t
Y
Y
Y
r
r
r
r
r
r
r
g
r
m
M
r
r
Y
t
t
t
t
t
t
u
"}
(24,1,1) = {"
u
t
t
t
t
t
t
t
t
t
t
t
t
t
t
t
Y
Y
Y
Y
Y
Y
Y
a
a
r
r
r
r
m
M
r
Y
t
t
t
t
t
t
u
"}
(25,1,1) = {"
u
t
t
t
t
t
t
t
t
t
t
t
t
t
t
t
t
t
t
t
t
t
Y
a
a
a
r
P
O
M
B
r
Y
Y
t
t
t
t
t
u
"}
(26,1,1) = {"
u
t
t
t
t
t
t
t
t
t
t
t
t
t
t
t
t
t
t
t
t
t
Y
Y
a
a
r
r
r
B
B
r
Y
Y
t
t
t
t
t
u
"}
(27,1,1) = {"
u
t
t
t
t
t
t
t
t
t
t
t
t
t
t
t
t
t
t
t
t
t
Y
Y
Y
Y
Y
r
r
B
B
r
Y
Y
t
t
t
t
t
u
"}
(28,1,1) = {"
u
t
t
t
t
t
t
t
t
t
t
t
t
t
t
t
t
t
t
t
t
t
t
t
t
t
Y
r
r
B
B
r
a
Y
t
t
t
t
t
u
"}
(29,1,1) = {"
u
t
t
t
t
t
t
t
t
t
t
t
t
t
t
t
t
t
t
t
t
t
t
t
t
t
Y
r
r
B
B
a
a
a
t
t
t
t
t
u
"}
(30,1,1) = {"
u
t
t
t
t
t
t
t
t
t
t
t
t
t
t
t
t
t
t
t
t
t
t
t
t
t
Y
a
a
a
a
a
a
a
f
t
t
t
t
u
"}
(31,1,1) = {"
u
t
t
t
t
t
t
t
t
t
t
t
t
t
t
t
t
t
t
t
t
t
t
t
t
t
Y
Y
a
a
a
a
a
a
f
t
t
t
t
u
"}
(32,1,1) = {"
u
t
t
t
t
t
t
t
t
t
t
t
t
t
t
t
t
t
t
t
t
t
t
t
t
t
t
Y
Y
a
a
a
a
a
f
t
t
t
t
u
"}
(33,1,1) = {"
u
t
t
t
t
t
t
t
t
t
t
t
t
t
t
t
t
t
t
t
t
t
t
t
t
t
t
Y
Y
Y
a
a
a
a
f
t
t
t
t
u
"}
(34,1,1) = {"
u
t
t
t
t
t
t
t
t
t
t
t
t
t
t
t
t
t
t
t
t
t
t
t
t
t
t
Y
Y
Y
Y
a
a
a
f
t
t
t
t
u
"}
(35,1,1) = {"
u
t
t
t
t
t
t
t
t
t
t
t
t
t
t
t
t
t
t
t
t
t
t
t
t
t
t
t
t
t
t
f
f
f
f
t
t
t
t
u
"}
(36,1,1) = {"
u
t
t
t
t
t
t
t
t
t
t
t
t
t
t
t
t
t
t
t
t
t
t
t
t
t
t
t
t
t
t
t
t
f
t
t
t
t
t
u
"}
(37,1,1) = {"
u
t
t
t
t
t
t
t
t
t
t
t
t
t
t
t
t
t
t
t
t
t
t
t
t
t
t
t
t
t
t
t
t
t
t
t
t
t
t
u
"}
(38,1,1) = {"
u
t
t
t
t
t
t
t
t
t
t
t
t
t
t
t
t
t
t
t
t
t
t
t
t
t
t
t
t
t
t
t
t
t
t
t
t
t
t
u
"}
(39,1,1) = {"
u
t
t
t
t
t
t
t
t
t
t
t
t
t
t
t
t
t
t
t
t
t
t
t
t
t
t
t
t
t
t
t
t
t
t
t
t
t
t
u
"}
(40,1,1) = {"
u
u
u
u
u
u
u
u
u
u
u
u
u
u
u
u
u
u
u
u
u
u
u
u
u
u
u
u
u
u
u
u
u
u
u
u
u
u
u
u
"}
