//MAP CONVERTED BY dmm2tgm.py THIS HEADER COMMENT PREVENTS RECONVERSION, DO NOT REMOVE
"a" = (
/turf/template_noop,
/area/template_noop)
"e" = (
/obj/structure/bed/chair/sofa/right/orange,
/obj/effect/mine/n2o,
/obj/item/trash/pretzel,
/turf/simulated/floor/plating/turfpack/muriki,
/area/mine/explored/muriki/cave/deepdark)
"n" = (
/obj/effect/auto_crayon{
	icon_state = "x"
	},
/turf/simulated/floor/plating/turfpack/muriki,
/area/mine/explored/muriki/cave/deepdark)
"p" = (
/turf/simulated/floor/plating/turfpack/muriki,
/area/mine/explored/muriki/cave/deepdark)
"v" = (
/obj/item/trash/snacktray,
/turf/simulated/floor/plating/turfpack/muriki,
/area/mine/explored/muriki/cave/deepdark)
"z" = (
/obj/item/assembly/mousetrap/armed,
/turf/simulated/floor/plating/turfpack/muriki,
/area/mine/explored/muriki/cave/deepdark)
"C" = (
/obj/item/trash/small_bowl,
/turf/simulated/floor/plating/turfpack/muriki,
/area/mine/explored/muriki/cave/deepdark)
"D" = (
/obj/machinery/door/airlock/maintenance_hatch,
/obj/effect/mine/frag,
/turf/simulated/floor/plating/turfpack/muriki,
/area/mine/explored/muriki/cave/deepdark)
"F" = (
/obj/effect/mine/n2o,
/obj/item/trash/snacktray,
/turf/simulated/floor/plating/turfpack/muriki,
/area/mine/explored/muriki/cave/deepdark)
"H" = (
/obj/structure/bed/chair/sofa/left/orange,
/turf/simulated/floor/plating/turfpack/muriki,
/area/mine/explored/muriki/cave/deepdark)
"O" = (
/turf/simulated/wall,
/area/mine/explored/muriki/cave/deepdark)
"T" = (
/obj/effect/landmark/loot_spawn,
/turf/simulated/floor/plating/turfpack/muriki,
/area/mine/explored/muriki/cave/deepdark)
"X" = (
/obj/structure/bed/chair/sofa/orange,
/turf/simulated/floor/plating/turfpack/muriki,
/area/mine/explored/muriki/cave/deepdark)

(1,1,1) = {"
a
a
a
a
a
a
a
a
"}
(2,1,1) = {"
a
a
p
a
p
p
p
a
"}
(3,1,1) = {"
a
a
p
O
n
O
a
a
"}
(4,1,1) = {"
a
O
O
O
D
O
O
a
"}
(5,1,1) = {"
a
O
e
z
p
v
O
a
"}
(6,1,1) = {"
a
O
X
p
C
p
O
a
"}
(7,1,1) = {"
a
O
H
T
z
p
O
a
"}
(8,1,1) = {"
a
O
O
p
p
F
O
a
"}
(9,1,1) = {"
a
a
O
O
O
O
O
a
"}
(10,1,1) = {"
a
a
a
a
a
a
a
a
"}
