//MAP CONVERTED BY dmm2tgm.py THIS HEADER COMMENT PREVENTS RECONVERSION, DO NOT REMOVE
"a" = (
/obj/machinery/smartfridge/drying_rack,
/turf/simulated/floor/plating,
/area/mine/explored/muriki/cave/deepdark)
"b" = (
/obj/structure/sink{
	dir = 4;
	pixel_x = 11
	},
/turf/simulated/floor/tiled,
/area/mine/explored/muriki/cave/deepdark)
"c" = (
/obj/structure/table/woodentable,
/obj/item/seeds/ambrosiavulgarisseed,
/obj/item/seeds/ambrosiavulgarisseed,
/obj/item/seeds/ambrosiavulgarisseed,
/turf/simulated/floor/plating,
/area/mine/explored/muriki/cave/deepdark)
"d" = (
/turf/simulated/mineral/alt/ignore_cavegen/turfpack/muriki,
/area/mine/explored/muriki/cave/deepdark)
"e" = (
/turf/simulated/floor/plating,
/area/mine/explored/muriki/cave/deepdark)
"h" = (
/mob/living/simple_mob/vore/reindeer,
/turf/simulated/floor/plating,
/area/mine/explored/muriki/cave/deepdark)
"m" = (
/obj/machinery/light,
/turf/simulated/floor/tiled,
/area/mine/explored/muriki/cave/deepdark)
"n" = (
/obj/machinery/light{
	dir = 1
	},
/obj/machinery/smartfridge/drying_rack,
/turf/simulated/floor/tiled,
/area/mine/explored/muriki/cave/deepdark)
"p" = (
/turf/template_noop,
/area/mine/explored/muriki/cave/deepdark)
"q" = (
/obj/random/thermalponcho,
/turf/simulated/floor/tiled,
/area/mine/explored/muriki/cave/deepdark)
"t" = (
/turf/simulated/floor/tiled,
/area/mine/explored/muriki/cave/deepdark)
"u" = (
/obj/machinery/portable_atmospherics/hydroponics,
/turf/simulated/floor/tiled,
/area/mine/explored/muriki/cave/deepdark)
"w" = (
/turf/simulated/floor/plating/turfpack/muriki,
/area/template_noop)
"y" = (
/turf/template_noop,
/area/template_noop)
"z" = (
/obj/structure/table/woodentable,
/obj/item/seeds/reishimycelium,
/obj/item/seeds/reishimycelium,
/obj/item/seeds/reishimycelium,
/turf/simulated/floor/plating,
/area/mine/explored/muriki/cave/deepdark)
"B" = (
/obj/item/material/minihoe,
/turf/simulated/floor/plating,
/area/mine/explored/muriki/cave/deepdark)
"D" = (
/obj/item/reagent_containers/glass/bucket,
/turf/simulated/floor/tiled,
/area/mine/explored/muriki/cave/deepdark)
"E" = (
/obj/structure/reagent_dispensers/watertank,
/turf/simulated/floor/tiled,
/area/mine/explored/muriki/cave/deepdark)
"G" = (
/turf/simulated/floor/plating/turfpack/muriki,
/area/mine/explored/muriki/cave/deepdark)
"H" = (
/obj/machinery/light,
/turf/simulated/floor/plating,
/area/mine/explored/muriki/cave/deepdark)
"J" = (
/obj/item/farmbot_arm_assembly,
/turf/simulated/floor/tiled,
/area/mine/explored/muriki/cave/deepdark)
"K" = (
/obj/machinery/portable_atmospherics/hydroponics,
/obj/fruitspawner/tobacco,
/obj/fruitspawner/tobacco,
/turf/simulated/floor/tiled,
/area/mine/explored/muriki/cave/deepdark)
"N" = (
/obj/machinery/portable_atmospherics/hydroponics,
/obj/fruitspawner/reishi,
/obj/fruitspawner/reishi,
/turf/simulated/floor/tiled,
/area/mine/explored/muriki/cave/deepdark)
"O" = (
/obj/machinery/portable_atmospherics/hydroponics,
/obj/fruitspawner/chili,
/obj/fruitspawner/chili,
/turf/simulated/floor/tiled,
/area/mine/explored/muriki/cave/deepdark)
"Q" = (
/turf/simulated/wall{
	can_open = 1
	},
/area/mine/explored/muriki/cave/deepdark)
"R" = (
/obj/machinery/portable_atmospherics/hydroponics,
/obj/fruitspawner/reishi,
/obj/fruitspawner/reishi,
/turf/simulated/floor/plating,
/area/mine/explored/muriki/cave/deepdark)
"S" = (
/obj/machinery/portable_atmospherics/hydroponics,
/obj/fruitspawner/ambrosia,
/obj/fruitspawner/ambrosia,
/turf/simulated/floor/tiled,
/area/mine/explored/muriki/cave/deepdark)
"T" = (
/obj/machinery/light{
	dir = 1
	},
/obj/machinery/vending/hydronutrients{
	emagged = 1;
	name = "Illicit NutriMax"
	},
/turf/simulated/floor/tiled,
/area/mine/explored/muriki/cave/deepdark)
"U" = (
/turf/simulated/mineral/alt/ignore_cavegen/turfpack/muriki,
/area/template_noop)
"W" = (
/obj/structure/table/woodentable,
/obj/item/seeds/ambrosiavulgarisseed,
/obj/item/seeds/ambrosiavulgarisseed,
/obj/item/seeds/ambrosiavulgarisseed,
/turf/simulated/floor/tiled,
/area/mine/explored/muriki/cave/deepdark)
"X" = (
/turf/simulated/wall,
/area/mine/explored/muriki/cave/deepdark)
"Y" = (
/obj/random/cutout,
/turf/simulated/floor/plating,
/area/mine/explored/muriki/cave/deepdark)
"Z" = (
/turf/simulated/mineral/floor/ignore_cavegen/turfpack/muriki,
/area/mine/explored/muriki/cave/deepdark)

(1,1,1) = {"
y
y
y
y
y
y
y
y
y
y
y
y
y
y
y
"}
(2,1,1) = {"
y
y
y
y
p
p
p
Z
Z
p
p
U
y
y
y
"}
(3,1,1) = {"
y
U
U
d
p
p
Z
Z
Z
Z
Z
d
U
y
y
"}
(4,1,1) = {"
y
U
U
d
d
X
X
X
X
X
X
d
U
y
y
"}
(5,1,1) = {"
y
y
U
d
X
X
J
q
e
R
X
Z
U
y
y
"}
(6,1,1) = {"
y
y
U
Z
X
E
D
e
e
N
X
Z
p
y
y
"}
(7,1,1) = {"
y
y
Z
G
X
T
t
c
e
H
X
Z
Z
y
y
"}
(8,1,1) = {"
y
w
G
G
Q
e
e
W
e
K
X
Z
Z
y
y
"}
(9,1,1) = {"
y
y
p
p
X
e
h
z
e
S
X
Z
Z
y
y
"}
(10,1,1) = {"
y
y
U
Z
X
n
e
z
B
m
X
Z
p
y
y
"}
(11,1,1) = {"
y
y
U
Z
X
a
e
e
e
O
X
d
p
y
y
"}
(12,1,1) = {"
y
y
y
p
X
X
Y
b
e
u
X
d
U
y
y
"}
(13,1,1) = {"
y
y
y
p
p
X
X
X
X
X
X
d
y
y
y
"}
(14,1,1) = {"
y
y
y
y
p
p
p
p
Z
Z
Z
y
y
y
y
"}
(15,1,1) = {"
y
y
y
y
y
y
y
y
y
y
y
y
y
y
y
"}
