//MAP CONVERTED BY dmm2tgm.py THIS HEADER COMMENT PREVENTS RECONVERSION, DO NOT REMOVE
"a" = (
/turf/simulated/mineral/alt/ignore_cavegen/turfpack/muriki,
/area/template_noop)
"b" = (
/obj/machinery/light/small{
	dir = 1
	},
/turf/simulated/floor/plating/turfpack/muriki,
/area/mine/explored/muriki/cave/deepdark)
"c" = (
/turf/simulated/floor/tiled/techfloor/turfpack/muriki,
/area/mine/explored/muriki/cave/deepdark)
"d" = (
/obj/structure/bed/padded,
/obj/item/bedsheet/mime,
/obj/effect/landmark/redspaceexit,
/turf/simulated/floor/plating/turfpack/muriki,
/area/mine/explored/muriki/cave/deepdark)
"e" = (
/obj/structure/bed/pillowpile/white,
/turf/simulated/floor/tiled/techfloor,
/area/mine/explored/muriki/cave/deepdark)
"h" = (
/turf/simulated/wall,
/area/mine/explored/muriki/cave/deepdark)
"i" = (
/obj/machinery/door/airlock/maintenance/int,
/turf/simulated/floor/tiled/techfloor/turfpack/muriki,
/area/mine/explored/muriki/cave/deepdark)
"k" = (
/turf/simulated/floor/plating/turfpack/muriki,
/area/mine/explored/muriki/cave/deepdark)
"m" = (
/obj/structure/trash_pile,
/turf/simulated/mineral/floor/ignore_cavegen/turfpack/muriki,
/area/mine/explored/muriki/cave/deepdark)
"p" = (
/turf/simulated/mineral/alt/ignore_cavegen/turfpack/muriki,
/area/mine/explored/muriki/cave/deepdark)
"s" = (
/obj/structure/table/woodentable,
/obj/item/flashlight/lamp,
/turf/simulated/floor/tiled/techfloor,
/area/mine/explored/muriki/cave/deepdark)
"t" = (
/obj/structure/table/steel,
/obj/random/maintenance/foodstuff,
/obj/random/maintenance/foodstuff,
/obj/item/flame/candle/everburn,
/obj/item/pen/crayon/marker/blue,
/turf/simulated/floor/plating/turfpack/muriki,
/area/mine/explored/muriki/cave/deepdark)
"u" = (
/obj/structure/bed/chair/bay/chair{
	dir = 1
	},
/turf/simulated/floor/tiled/techfloor,
/area/mine/explored/muriki/cave/deepdark)
"w" = (
/obj/structure/trash_pile,
/turf/simulated/mineral/floor/ignore_cavegen/turfpack/muriki,
/area/template_noop)
"F" = (
/turf/simulated/mineral/floor/ignore_cavegen/turfpack/muriki,
/area/mine/explored/muriki/cave/deepdark)
"J" = (
/turf/simulated/mineral/floor/ignore_cavegen/turfpack/muriki,
/area/template_noop)
"L" = (
/obj/structure/table/woodentable,
/turf/simulated/floor/tiled/techfloor,
/area/mine/explored/muriki/cave/deepdark)
"M" = (
/obj/structure/bed/bath,
/turf/simulated/floor/plating/turfpack/muriki,
/area/mine/explored/muriki/cave/deepdark)
"R" = (
/obj/structure/bed/pillowpile/white,
/turf/simulated/floor/plating/turfpack/muriki,
/area/mine/explored/muriki/cave/deepdark)
"T" = (
/obj/structure/grille,
/obj/structure/window/reinforced/full,
/turf/simulated/floor/plating,
/area/mine/explored/muriki/cave/deepdark)
"V" = (
/obj/structure/table/steel,
/obj/random/maintenance/security,
/obj/random/maintenance/misc,
/turf/simulated/floor/plating/turfpack/muriki,
/area/mine/explored/muriki/cave/deepdark)
"W" = (
/turf/template_noop,
/area/template_noop)
"Z" = (
/turf/template_noop,
/area/mine/explored/muriki/cave/deepdark)

(1,1,1) = {"
W
W
W
W
W
W
W
W
W
W
W
W
W
W
W
W
W
W
W
W
"}
(2,1,1) = {"
W
W
W
W
a
a
a
a
a
a
W
W
W
W
W
W
W
W
W
W
"}
(3,1,1) = {"
W
W
J
J
a
a
a
a
a
a
p
p
p
p
p
p
p
Z
W
W
"}
(4,1,1) = {"
W
W
J
J
J
J
a
a
a
p
p
p
p
p
p
p
p
p
Z
W
"}
(5,1,1) = {"
W
J
J
J
J
J
J
a
p
p
p
p
p
h
h
h
h
h
Z
W
"}
(6,1,1) = {"
W
J
J
J
J
J
J
J
m
p
p
p
p
h
d
k
M
h
F
W
"}
(7,1,1) = {"
W
J
J
J
J
J
J
J
F
F
h
h
h
h
b
k
k
i
F
W
"}
(8,1,1) = {"
W
J
J
J
J
J
J
J
F
F
T
L
e
h
t
k
R
h
m
W
"}
(9,1,1) = {"
W
J
J
J
J
J
J
J
F
F
T
c
c
i
k
k
V
h
Z
W
"}
(10,1,1) = {"
W
J
J
J
J
J
J
J
F
F
T
s
u
h
h
h
h
h
Z
W
"}
(11,1,1) = {"
W
J
J
J
J
J
J
J
F
F
h
h
h
h
p
p
p
p
Z
W
"}
(12,1,1) = {"
W
J
a
J
J
J
J
J
F
F
p
p
p
p
p
p
p
p
Z
W
"}
(13,1,1) = {"
W
a
a
a
w
J
J
J
J
p
p
p
p
p
p
p
p
p
W
W
"}
(14,1,1) = {"
W
a
a
a
J
J
J
J
a
p
p
p
p
p
p
p
p
W
W
W
"}
(15,1,1) = {"
W
W
a
a
J
J
J
J
a
a
p
p
p
p
p
p
a
W
W
W
"}
(16,1,1) = {"
W
W
J
J
J
J
J
J
J
a
a
a
a
a
a
a
W
W
W
W
"}
(17,1,1) = {"
W
W
W
J
J
J
J
J
J
a
a
a
a
a
a
a
W
W
W
W
"}
(18,1,1) = {"
W
W
W
W
W
J
J
J
J
J
a
a
a
a
W
W
W
W
W
W
"}
(19,1,1) = {"
W
W
W
W
W
W
W
W
W
W
W
W
W
W
W
W
W
W
W
W
"}
(20,1,1) = {"
W
W
W
W
W
W
W
W
W
W
W
W
W
W
W
W
W
W
W
W
"}
