//MAP CONVERTED BY dmm2tgm.py THIS HEADER COMMENT PREVENTS RECONVERSION, DO NOT REMOVE
"a" = (
/turf/template_noop,
/area/template_noop)
"i" = (
/obj/item/bone/skull,
/turf/simulated/mineral/floor/ignore_mapgen/cave,
/area/mine/explored/muriki/cave/deepdark)
"o" = (
/turf/simulated/mineral/alt/ignore_mapgen/turfpack/muriki,
/area/mine/explored/muriki/cave/deepdark)
"w" = (
/obj/item/digestion_remains/skull/zorren,
/turf/simulated/mineral/floor/ignore_mapgen/cave,
/area/mine/explored/muriki/cave/deepdark)
"z" = (
/obj/effect/landmark/hostile_xenobio,
/turf/simulated/mineral/floor/ignore_mapgen/cave,
/area/mine/explored/muriki/cave/deepdark)
"J" = (
/turf/simulated/mineral/floor/ignore_mapgen/cave,
/area/mine/explored/muriki/cave/deepdark)
"T" = (
/obj/structure/loot_pile/surface/bones,
/turf/simulated/mineral/floor/ignore_mapgen/cave,
/area/mine/explored/muriki/cave/deepdark)

(1,1,1) = {"
a
a
a
a
a
a
a
"}
(2,1,1) = {"
a
o
o
w
J
o
a
"}
(3,1,1) = {"
a
o
J
J
J
T
a
"}
(4,1,1) = {"
a
J
J
z
J
J
a
"}
(5,1,1) = {"
a
o
i
J
J
J
a
"}
(6,1,1) = {"
a
o
J
T
J
o
a
"}
(7,1,1) = {"
a
a
a
a
a
a
a
"}
