//MAP CONVERTED BY dmm2tgm.py THIS HEADER COMMENT PREVENTS RECONVERSION, DO NOT REMOVE
"a" = (
/turf/template_noop,
/area/mine/explored/muriki/cave/deepdark)
"b" = (
/turf/simulated/mineral/alt/ignore_cavegen/turfpack/muriki,
/area/template_noop)
"g" = (
/obj/effect/floor_decal/corner/black/border{
	dir = 4
	},
/obj/effect/floor_decal/corner/white/border{
	dir = 8
	},
/obj/machinery/light/small{
	dir = 1
	},
/turf/simulated/floor/tiled/monotile,
/area/mine/explored/muriki/cave/deepdark)
"l" = (
/turf/simulated/floor/tiled/monotile,
/area/mine/explored/muriki/cave/deepdark)
"o" = (
/obj/effect/floor_decal/corner/black/border{
	dir = 4
	},
/obj/effect/floor_decal/corner/white/border{
	dir = 8
	},
/turf/simulated/floor/tiled/monotile,
/area/mine/explored/muriki/cave/deepdark)
"p" = (
/turf/simulated/mineral/alt/ignore_cavegen/turfpack/muriki,
/area/mine/explored/muriki/cave/deepdark)
"t" = (
/obj/machinery/light/small{
	dir = 4
	},
/turf/simulated/floor/tiled/monotile,
/area/mine/explored/muriki/cave/deepdark)
"z" = (
/turf/simulated/mineral/floor/ignore_cavegen/turfpack/muriki,
/area/template_noop)
"A" = (
/turf/simulated/wall,
/area/mine/explored/muriki/cave/deepdark)
"B" = (
/obj/structure/railing,
/turf/simulated/floor/tiled/monotile,
/area/mine/explored/muriki/cave/deepdark)
"D" = (
/turf/template_noop,
/area/template_noop)
"H" = (
/obj/machinery/light/small{
	dir = 8
	},
/turf/simulated/floor/tiled/monotile,
/area/mine/explored/muriki/cave/deepdark)
"I" = (
/obj/item/beach_ball/dodgeball,
/obj/item/beach_ball/dodgeball,
/turf/simulated/floor/tiled/monotile,
/area/mine/explored/muriki/cave/deepdark)
"J" = (
/turf/simulated/mineral/floor/ignore_cavegen/turfpack/muriki,
/area/mine/explored/muriki/cave/deepdark)
"K" = (
/turf/simulated/floor/plating/turfpack/muriki,
/area/mine/explored/muriki/cave/deepdark)
"N" = (
/obj/effect/floor_decal/corner/black/border{
	dir = 4
	},
/obj/effect/floor_decal/corner/white/border{
	dir = 8
	},
/obj/machinery/light/small,
/turf/simulated/floor/tiled/monotile,
/area/mine/explored/muriki/cave/deepdark)
"O" = (
/turf/simulated/floor/plating/turfpack/muriki,
/area/template_noop)
"V" = (
/obj/item/beach_ball/dodgeball,
/obj/item/beach_ball/dodgeball,
/obj/item/beach_ball/dodgeball,
/obj/item/beach_ball/dodgeball,
/obj/item/beach_ball/dodgeball,
/turf/simulated/floor/tiled/monotile,
/area/mine/explored/muriki/cave/deepdark)
"W" = (
/obj/machinery/door/airlock/maintenance/int,
/turf/simulated/floor/plating/turfpack/muriki,
/area/mine/explored/muriki/cave/deepdark)
"Z" = (
/obj/structure/railing{
	dir = 1
	},
/turf/simulated/floor/tiled/monotile,
/area/mine/explored/muriki/cave/deepdark)

(1,1,1) = {"
D
D
D
D
D
D
D
D
D
D
D
D
D
D
D
D
D
D
D
D
"}
(2,1,1) = {"
D
D
D
D
D
D
D
D
D
z
z
z
z
D
D
D
D
D
D
D
"}
(3,1,1) = {"
D
D
D
D
D
D
z
z
z
b
b
b
b
b
b
b
b
b
D
D
"}
(4,1,1) = {"
D
D
D
a
a
p
p
p
p
p
p
p
p
p
p
p
p
p
a
D
"}
(5,1,1) = {"
D
D
J
A
A
A
A
A
A
A
A
A
A
A
A
A
A
A
a
D
"}
(6,1,1) = {"
D
z
K
A
l
l
B
I
l
H
V
H
l
I
Z
l
l
A
p
D
"}
(7,1,1) = {"
D
O
K
W
l
l
B
l
l
l
l
l
l
l
Z
l
l
A
p
D
"}
(8,1,1) = {"
D
z
p
A
l
t
l
l
l
l
l
l
l
l
l
t
l
A
p
D
"}
(9,1,1) = {"
D
z
p
A
A
A
A
l
l
l
l
l
l
l
A
A
A
A
p
D
"}
(10,1,1) = {"
D
D
p
p
p
p
A
l
l
l
l
l
l
l
A
p
p
p
J
D
"}
(11,1,1) = {"
D
D
a
a
p
p
A
g
o
o
o
o
o
N
A
p
p
J
J
D
"}
(12,1,1) = {"
D
D
a
a
a
a
A
l
l
l
l
l
l
l
A
J
J
J
a
D
"}
(13,1,1) = {"
D
D
a
A
A
A
A
l
l
l
l
l
l
l
A
A
A
A
a
D
"}
(14,1,1) = {"
D
D
J
A
l
H
l
l
l
l
l
l
l
l
l
H
l
A
a
D
"}
(15,1,1) = {"
D
z
J
W
l
l
B
l
l
l
l
l
l
l
Z
l
l
A
a
D
"}
(16,1,1) = {"
D
D
K
A
l
l
B
I
l
t
V
t
l
I
Z
l
l
A
a
D
"}
(17,1,1) = {"
D
D
D
A
A
A
A
A
A
A
A
A
A
A
A
A
A
A
a
D
"}
(18,1,1) = {"
D
D
D
a
p
p
p
p
p
p
p
p
p
p
p
p
p
a
a
D
"}
(19,1,1) = {"
D
D
D
D
D
z
z
z
b
b
b
b
b
b
b
D
D
D
D
D
"}
(20,1,1) = {"
D
D
D
D
D
D
D
D
D
D
D
D
D
D
D
D
D
D
D
D
"}
