//MAP CONVERTED BY dmm2tgm.py THIS HEADER COMMENT PREVENTS RECONVERSION, DO NOT REMOVE
"a" = (
/turf/simulated/floor/wood/alt,
/area/mine/explored/muriki/cave/deepdark)
"c" = (
/obj/machinery/door/airlock/maintenance/int,
/turf/simulated/floor/tiled/techfloor/turfpack/muriki,
/area/mine/explored/muriki/cave/deepdark)
"e" = (
/turf/simulated/floor/wood/alt/broken,
/area/mine/explored/muriki/cave/deepdark)
"o" = (
/turf/simulated/mineral/alt/ignore_cavegen/turfpack/muriki,
/area/mine/explored/muriki/cave/deepdark)
"q" = (
/turf/simulated/floor/plating/turfpack/muriki,
/area/mine/explored/muriki/cave/deepdark)
"x" = (
/turf/template_noop,
/area/mine/explored/muriki/cave/deepdark)
"C" = (
/turf/template_noop,
/area/template_noop)
"G" = (
/turf/simulated/mineral/floor/ignore_cavegen/turfpack/muriki,
/area/mine/explored/muriki/cave/deepdark)
"R" = (
/turf/simulated/wall,
/area/mine/explored/muriki/cave/deepdark)
"S" = (
/obj/machinery/light/small{
	dir = 4
	},
/turf/simulated/floor/wood/alt,
/area/mine/explored/muriki/cave/deepdark)

(1,1,1) = {"
C
C
C
C
C
C
C
C
C
C
"}
(2,1,1) = {"
C
o
R
R
R
R
R
R
G
C
"}
(3,1,1) = {"
C
G
R
q
e
a
q
R
o
C
"}
(4,1,1) = {"
C
G
c
a
a
q
a
R
o
C
"}
(5,1,1) = {"
C
o
R
a
a
q
e
R
o
C
"}
(6,1,1) = {"
C
o
R
q
e
q
R
R
o
C
"}
(7,1,1) = {"
C
o
R
S
q
q
R
o
G
C
"}
(8,1,1) = {"
C
x
R
R
R
R
R
o
G
C
"}
(9,1,1) = {"
C
C
x
o
o
o
o
x
C
C
"}
(10,1,1) = {"
C
C
C
C
C
C
C
C
C
C
"}
