//MAP CONVERTED BY dmm2tgm.py THIS HEADER COMMENT PREVENTS RECONVERSION, DO NOT REMOVE
"a" = (
/turf/simulated/mineral/alt/ignore_cavegen/turfpack/muriki,
/area/mine/explored/muriki/cave/deepdark)
"c" = (
/mob/living/simple_mob/vore/aggressive/giant_snake,
/turf/simulated/floor/outdoors/grass/forest/turfpack/muriki,
/area/mine/explored/muriki/cave/deepdark)
"d" = (
/mob/living/simple_mob/vore/pitcher,
/turf/simulated/floor/outdoors/grass/forest/turfpack/muriki,
/area/mine/explored/muriki/cave/deepdark)
"e" = (
/obj/effect/landmark/step_trap,
/turf/simulated/floor/outdoors/grass/forest/turfpack/muriki,
/area/mine/explored/muriki/cave/deepdark)
"f" = (
/obj/machinery/portable_atmospherics/hydroponics/soil,
/turf/simulated/floor/outdoors/grass/heavy/turfpack/muriki,
/area/mine/explored/muriki/cave/deepdark)
"h" = (
/obj/item/beartrap{
	anchored = 1;
	deployed = 1
	},
/turf/simulated/floor/outdoors/grass/forest/turfpack/muriki,
/area/mine/explored/muriki/cave/deepdark)
"i" = (
/obj/item/storage/firstaid/bonemed,
/turf/simulated/floor/outdoors/grass/forest/turfpack/muriki,
/area/mine/explored/muriki/cave/deepdark)
"j" = (
/obj/random/outcrop,
/turf/simulated/floor/outdoors/grass/heavy/turfpack/muriki,
/area/mine/explored/muriki/cave/deepdark)
"k" = (
/obj/effect/landmark/hostile_xenobio,
/turf/simulated/floor/outdoors/grass/forest/turfpack/muriki,
/area/mine/explored/muriki/cave/deepdark)
"l" = (
/obj/random/cutout,
/turf/simulated/floor/outdoors/grass/heavy/turfpack/muriki,
/area/mine/explored/muriki/cave/deepdark)
"o" = (
/obj/item/beartrap{
	anchored = 1;
	deployed = 1
	},
/turf/simulated/floor/outdoors/grass/heavy/turfpack/muriki,
/area/mine/explored/muriki/cave/deepdark)
"p" = (
/obj/effect/landmark/vermin,
/turf/simulated/floor/outdoors/grass/forest/turfpack/muriki,
/area/mine/explored/muriki/cave/deepdark)
"s" = (
/obj/effect/mine/frag,
/turf/simulated/floor/outdoors/grass/heavy/turfpack/muriki,
/area/mine/explored/muriki/cave/deepdark)
"u" = (
/obj/item/spellbook/oneuse/buttblast,
/turf/simulated/floor/outdoors/grass/heavy/turfpack/muriki,
/area/mine/explored/muriki/cave/deepdark)
"v" = (
/obj/effect/landmark/event_spawn/maintpred,
/turf/simulated/floor/outdoors/grass/heavy/turfpack/muriki,
/area/mine/explored/muriki/cave/deepdark)
"w" = (
/mob/living/simple_mob/vore/mantrap,
/turf/simulated/floor/outdoors/grass/forest/turfpack/muriki,
/area/mine/explored/muriki/cave/deepdark)
"x" = (
/obj/structure/closet/crate/mimic/cointoss,
/obj/random/contraband,
/turf/simulated/floor/outdoors/grass/forest/turfpack/muriki,
/area/mine/explored/muriki/cave/deepdark)
"y" = (
/mob/living/simple_mob/vore/slug,
/turf/simulated/floor/outdoors/mud/turfpack/muriki{
	outdoors = 0
	},
/area/mine/explored/muriki/cave/deepdark)
"z" = (
/obj/item/dnainjector/random_verygood_labeled,
/turf/simulated/floor/outdoors/grass/forest/turfpack/muriki,
/area/mine/explored/muriki/cave/deepdark)
"B" = (
/mob/living/simple_mob/vore/pitcher_plant,
/turf/simulated/floor/outdoors/grass/forest/turfpack/muriki,
/area/mine/explored/muriki/cave/deepdark)
"C" = (
/turf/simulated/mineral/alt/turfpack/muriki,
/area/mine/explored/muriki/cave/deepdark)
"G" = (
/obj/machinery/portable_atmospherics/hydroponics/soil,
/turf/simulated/floor/outdoors/grass/forest/turfpack/muriki,
/area/mine/explored/muriki/cave/deepdark)
"H" = (
/turf/simulated/floor/water/acidic/indoor/turfpack/muriki,
/area/mine/explored/muriki/cave/deepdark)
"I" = (
/obj/effect/mine/frag{
	camo_net = 1
	},
/turf/simulated/floor/outdoors/grass/heavy/turfpack/muriki,
/area/mine/explored/muriki/cave/deepdark)
"J" = (
/obj/effect/mine/frag,
/turf/simulated/floor/outdoors/grass/forest/turfpack/muriki,
/area/mine/explored/muriki/cave/deepdark)
"L" = (
/obj/random/outcrop,
/turf/simulated/floor/outdoors/grass/forest/turfpack/muriki,
/area/mine/explored/muriki/cave/deepdark)
"M" = (
/turf/simulated/floor/outdoors/grass/heavy/turfpack/muriki,
/area/mine/explored/muriki/cave/deepdark)
"N" = (
/mob/living/simple_mob/vore/pitcher,
/turf/simulated/floor/outdoors/grass/heavy/turfpack/muriki,
/area/mine/explored/muriki/cave/deepdark)
"O" = (
/mob/living/simple_mob/vore/mantrap,
/turf/simulated/floor/outdoors/grass/heavy/turfpack/muriki,
/area/mine/explored/muriki/cave/deepdark)
"P" = (
/obj/item/dnainjector/random,
/turf/simulated/floor/outdoors/grass/heavy/turfpack/muriki,
/area/mine/explored/muriki/cave/deepdark)
"Q" = (
/turf/simulated/floor/outdoors/grass/forest/turfpack/muriki,
/area/mine/explored/muriki/cave/deepdark)
"R" = (
/obj/random/cutout,
/turf/simulated/floor/outdoors/grass/forest/turfpack/muriki,
/area/mine/explored/muriki/cave/deepdark)
"S" = (
/turf/simulated/floor/plating/turfpack/muriki,
/area/mine/explored/muriki/cave/deepdark)
"U" = (
/turf/simulated/floor/outdoors/mud/turfpack/muriki{
	outdoors = 0
	},
/area/mine/explored/muriki/cave/deepdark)
"V" = (
/obj/effect/landmark/event_spawn/maintpred,
/turf/simulated/floor/outdoors/grass/forest/turfpack/muriki,
/area/mine/explored/muriki/cave/deepdark)
"W" = (
/turf/template_noop,
/area/template_noop)
"X" = (
/turf/template_noop,
/area/mine/explored/muriki/cave/deepdark)
"Z" = (
/obj/structure/loot_pile/surface/bones,
/turf/simulated/floor/outdoors/grass/forest/turfpack/muriki,
/area/mine/explored/muriki/cave/deepdark)

(1,1,1) = {"
W
W
W
W
W
W
W
W
W
W
W
W
W
W
W
W
W
W
W
W
W
W
W
W
W
W
W
W
W
W
W
W
W
W
W
W
W
W
W
W
"}
(2,1,1) = {"
W
W
W
W
W
W
W
W
W
W
W
W
W
W
W
W
W
W
W
W
W
W
W
W
W
W
W
W
W
W
W
W
W
W
W
W
W
W
W
W
"}
(3,1,1) = {"
W
W
W
W
W
W
W
W
W
W
W
W
X
X
X
X
X
X
X
X
X
X
X
X
X
X
X
X
W
W
W
W
W
W
W
W
W
W
W
W
"}
(4,1,1) = {"
W
W
W
W
W
W
W
W
W
X
X
X
X
X
X
a
a
a
X
X
a
a
a
a
X
X
X
X
X
X
X
X
W
W
W
W
W
W
W
W
"}
(5,1,1) = {"
W
W
W
W
W
W
W
W
X
X
X
X
a
a
a
a
a
a
a
a
a
Q
Q
a
a
a
a
a
a
X
X
X
X
W
W
W
W
W
W
W
"}
(6,1,1) = {"
W
W
W
W
W
W
W
X
X
X
a
a
a
a
a
Q
Q
Q
Q
Q
Q
Q
Q
Q
Q
a
a
a
a
a
a
X
X
W
W
W
W
W
W
W
"}
(7,1,1) = {"
W
W
W
W
W
W
W
X
X
X
a
a
a
a
a
Q
Q
Q
Q
Q
Q
Q
Q
Q
Q
Q
a
a
a
a
a
a
a
X
W
W
W
W
W
W
"}
(8,1,1) = {"
W
W
W
W
W
W
X
X
X
a
a
a
a
a
Q
Q
Q
Q
Q
Q
Q
Q
Q
Q
Q
Q
Q
Q
a
a
a
a
a
a
X
X
X
W
W
W
"}
(9,1,1) = {"
W
W
W
W
W
W
X
X
X
a
a
a
a
Q
Q
Q
Q
Q
Q
Q
M
M
M
M
M
Q
Q
Q
Q
Q
Q
a
a
a
X
X
X
X
W
W
"}
(10,1,1) = {"
W
W
W
W
W
W
X
X
X
a
a
a
Q
Q
Q
Q
Q
M
M
Q
Q
M
M
M
M
M
Q
Q
Q
M
Q
Q
a
a
a
a
X
X
W
W
"}
(11,1,1) = {"
W
W
W
W
W
W
X
X
a
a
a
a
Q
Q
Q
M
M
M
M
M
M
M
M
M
M
M
M
M
Q
Q
Q
Q
a
a
a
a
X
X
W
W
"}
(12,1,1) = {"
W
W
W
W
W
W
X
X
a
a
a
a
Q
Q
M
M
M
M
M
M
M
M
M
M
M
M
M
M
M
M
Q
Q
a
a
a
a
a
X
X
W
"}
(13,1,1) = {"
W
W
W
W
W
W
X
X
a
a
a
Q
Q
Q
M
M
M
M
a
w
Q
G
M
M
M
M
M
M
M
M
Q
Q
a
a
a
a
a
X
X
W
"}
(14,1,1) = {"
W
W
W
W
W
W
X
X
a
a
a
Q
Q
Q
M
M
M
M
M
Q
Q
Q
Q
Q
M
Q
Q
Q
Q
M
Q
Q
Q
a
a
a
a
a
X
W
"}
(15,1,1) = {"
W
W
W
W
W
W
X
X
X
a
a
Q
Q
Q
Q
M
M
M
N
Q
Q
Q
B
Q
Q
Q
Q
h
Q
Q
Q
Q
Q
a
a
a
a
a
X
W
"}
(16,1,1) = {"
W
W
W
W
W
W
X
X
X
a
w
Q
Q
Q
Q
Q
M
M
M
Q
Q
Q
Q
Q
x
Q
Q
Q
Q
Q
Q
Q
Q
a
a
a
a
a
X
W
"}
(17,1,1) = {"
W
W
W
W
W
W
X
X
X
a
Q
G
a
Q
Q
Q
M
M
M
M
Q
Q
Q
Q
Q
Q
Q
Q
Q
Q
Q
Q
Q
Q
a
a
a
a
X
W
"}
(18,1,1) = {"
W
W
W
W
W
W
X
X
X
a
Q
a
Q
Q
Q
Q
M
M
M
M
M
M
Q
Q
Q
Q
V
Q
Q
Q
Q
Q
Q
Q
a
a
a
a
X
W
"}
(19,1,1) = {"
W
W
W
W
W
W
X
X
X
a
Q
Q
Q
V
Q
Q
Q
Q
M
M
M
M
M
Q
Q
Q
Q
Q
a
a
Q
Q
Q
Q
a
a
a
a
X
W
"}
(20,1,1) = {"
W
W
W
W
W
W
X
X
X
a
a
Q
Q
Q
Q
Q
Q
Q
Q
Q
Q
Q
Q
Q
Q
Q
Q
Q
Q
Q
M
M
Q
Q
a
a
a
a
X
W
"}
(21,1,1) = {"
W
W
W
W
W
W
X
X
a
a
a
Q
Q
Q
J
Q
h
Q
Q
Q
Q
Q
Q
Q
Q
Q
Q
Q
Q
Q
Q
M
w
Q
a
a
a
X
X
W
"}
(22,1,1) = {"
W
W
W
W
W
W
X
X
a
a
a
a
Q
Q
Q
Q
Q
Q
Q
Q
Q
H
H
Q
Q
Q
Q
Q
Q
Q
M
M
Q
Q
a
a
a
X
X
W
"}
(23,1,1) = {"
W
W
W
W
W
W
X
X
a
a
a
a
Q
Q
Q
p
Q
M
Q
Q
Q
H
H
Q
Z
Q
Q
Q
M
M
M
N
M
Q
a
a
X
X
W
W
"}
(24,1,1) = {"
W
W
W
W
W
W
X
X
a
a
a
a
a
Q
Q
M
Q
M
N
M
Q
H
H
H
i
Q
Q
Q
M
Q
M
M
M
Q
a
X
X
X
W
W
"}
(25,1,1) = {"
W
W
W
W
W
W
X
X
a
a
a
a
a
Q
Q
Q
O
M
M
f
Q
Q
Q
Q
Q
Q
Q
Q
Q
f
M
f
M
M
a
X
X
X
W
W
"}
(26,1,1) = {"
W
W
W
W
W
W
X
X
X
a
a
a
a
Q
Q
Q
M
M
M
M
Q
Q
Q
Q
Q
Q
Q
Q
Q
Q
M
M
Q
Q
a
X
X
W
W
W
"}
(27,1,1) = {"
W
W
W
W
W
W
X
X
X
a
a
a
a
a
Q
Q
M
M
M
M
M
M
Q
Q
U
U
U
Q
Q
Q
M
M
Q
Q
a
X
X
W
W
W
"}
(28,1,1) = {"
W
W
W
W
W
W
W
X
X
X
a
a
a
a
a
Q
Q
M
M
a
M
Q
Q
Q
Q
y
U
L
Q
Q
Q
Q
Q
Q
a
X
W
W
W
W
"}
(29,1,1) = {"
W
W
W
W
W
W
W
X
X
X
a
a
a
a
a
a
Q
Q
M
M
M
Q
Q
a
Q
Q
Q
Q
Q
Q
Q
Q
Q
Q
a
X
W
W
W
W
"}
(30,1,1) = {"
W
W
W
W
W
W
W
W
X
X
X
a
a
a
a
a
Q
Q
Q
Q
Q
Q
Q
Q
Q
Q
Q
Q
Q
Q
Q
Q
Q
H
a
X
W
W
W
W
"}
(31,1,1) = {"
W
W
W
W
W
W
W
W
W
X
X
X
X
a
a
a
Q
Q
B
Q
Q
Q
Q
Q
Q
Q
Q
Q
Q
Q
p
Q
Q
H
a
X
X
W
W
W
"}
(32,1,1) = {"
W
W
W
W
W
W
W
W
W
X
X
X
X
X
a
a
Q
Q
Q
Q
Q
Q
Q
Q
Q
R
Q
Q
Q
Q
Q
Q
Q
H
a
X
X
W
W
W
"}
(33,1,1) = {"
W
W
W
W
W
W
W
W
W
X
X
X
X
X
X
a
a
Q
Q
Q
Q
Q
Q
Q
o
M
Q
Q
Q
Q
Q
Q
H
H
a
X
X
W
W
W
"}
(34,1,1) = {"
W
W
W
W
W
W
W
W
W
X
X
X
X
X
X
a
C
S
Q
Q
Q
Q
M
M
M
P
Q
c
Q
Q
Q
H
H
a
a
a
X
X
W
W
"}
(35,1,1) = {"
W
W
W
W
W
W
W
W
W
X
X
X
X
X
X
a
S
J
w
Q
Q
Q
M
M
M
M
Q
Q
Q
Q
Q
H
a
a
a
a
X
X
W
W
"}
(36,1,1) = {"
W
W
W
W
W
W
W
W
X
X
X
X
X
X
a
a
a
Q
Q
Q
Q
Q
M
w
Q
Q
Q
Q
Q
Q
Q
H
a
a
a
a
a
X
X
W
"}
(37,1,1) = {"
W
W
W
W
W
W
W
W
X
X
X
X
X
X
a
a
a
Q
Q
Q
Q
Q
M
G
Q
Q
Q
Q
Q
Q
Q
H
a
a
a
a
a
X
X
W
"}
(38,1,1) = {"
W
W
W
W
W
W
W
W
X
X
X
X
X
X
a
a
a
Q
Q
Q
Q
Q
Q
H
Q
Q
Q
Q
B
Q
Q
Q
a
a
a
a
a
a
X
W
"}
(39,1,1) = {"
W
W
W
W
W
W
W
X
X
X
X
X
X
a
a
a
Q
Q
Q
Q
e
Q
Q
H
a
a
Q
Q
Q
Q
Q
U
a
a
a
a
a
a
X
W
"}
(40,1,1) = {"
W
W
W
W
W
W
W
X
X
X
X
X
a
a
a
a
Q
Q
Q
Q
Q
d
H
H
a
Q
Q
Q
Q
Q
U
U
a
a
a
a
a
a
a
W
"}
(41,1,1) = {"
W
W
W
W
W
W
X
X
X
X
a
a
a
a
a
a
Q
Q
Q
a
Q
Q
Q
a
Q
Q
Q
Q
Q
Q
U
U
a
a
a
a
a
a
a
W
"}
(42,1,1) = {"
W
W
W
W
W
W
X
X
X
a
a
a
a
a
a
a
Q
Q
Q
a
a
a
a
a
M
M
G
Q
Q
M
M
U
a
a
a
a
a
a
a
W
"}
(43,1,1) = {"
W
W
W
W
W
W
X
X
a
a
a
a
a
a
a
Q
G
Q
Q
Q
a
a
Q
Q
M
M
M
M
M
M
M
I
u
a
a
a
a
a
a
W
"}
(44,1,1) = {"
W
W
W
W
X
X
X
a
a
a
a
a
a
a
a
Q
Q
Q
Q
Q
Q
Q
Q
Q
Q
M
M
M
M
M
w
M
a
a
a
a
a
a
X
W
"}
(45,1,1) = {"
W
W
W
W
X
X
a
a
a
a
a
a
Q
Q
Q
Q
Q
Q
w
Q
Q
Q
Q
Q
M
M
M
v
M
Q
Q
Q
Q
a
a
a
a
a
X
W
"}
(46,1,1) = {"
W
W
W
X
X
X
a
a
a
a
a
a
Q
M
M
Q
M
Q
Q
Q
Q
Q
Q
Q
Q
M
M
M
M
Q
Q
Q
Q
Q
a
a
a
X
X
W
"}
(47,1,1) = {"
W
W
W
X
X
a
a
a
a
a
Q
Q
Q
M
M
M
M
Q
Q
Q
Q
a
a
Q
Q
Q
Q
Q
Q
Q
Q
Q
Q
Q
a
a
a
X
W
W
"}
(48,1,1) = {"
W
W
W
X
X
a
a
a
a
Q
Q
Q
Q
M
M
M
M
Q
Q
Q
Q
Q
a
Q
Q
Q
Q
Q
Q
Q
Q
Q
Q
a
a
a
X
X
W
W
"}
(49,1,1) = {"
W
W
X
X
X
a
a
a
Q
Q
Q
Q
Q
N
M
M
v
Q
Q
Q
Q
Q
Q
Q
Q
Q
Q
Q
Q
Q
z
Q
Q
Q
Q
a
X
X
W
W
"}
(50,1,1) = {"
W
W
X
X
a
a
a
a
Q
Q
Q
Q
M
M
M
M
M
Q
Q
B
M
Q
Q
Q
Q
Q
M
O
M
M
N
M
M
G
Q
a
X
W
W
W
"}
(51,1,1) = {"
W
W
X
X
a
a
a
U
Q
Q
Q
a
M
M
M
M
M
Q
Z
Q
M
M
Q
Q
Q
Q
M
M
M
M
M
Q
U
Q
Q
a
X
W
W
W
"}
(52,1,1) = {"
W
W
X
X
X
a
U
M
Q
Q
Q
j
M
M
f
M
Q
Q
Q
Q
Q
M
Q
Q
Q
J
M
M
M
M
M
H
U
U
a
a
X
W
W
W
"}
(53,1,1) = {"
W
W
X
X
a
a
U
M
Q
Q
M
M
M
M
M
Q
Q
Q
Q
Q
Q
Q
l
Q
Q
M
M
M
M
Q
H
H
H
U
a
X
X
W
W
W
"}
(54,1,1) = {"
W
W
X
X
a
O
M
M
Q
M
M
M
M
M
M
Q
Q
Q
Q
Q
Q
Q
M
M
Q
Q
M
Q
H
H
H
H
H
U
a
W
W
W
W
W
"}
(55,1,1) = {"
W
W
X
X
a
M
M
M
Q
M
M
M
Q
Q
Q
Q
Q
Q
Q
Q
Q
Q
Q
Q
Q
Q
Q
Q
H
H
H
H
Q
a
a
W
W
W
W
W
"}
(56,1,1) = {"
W
W
X
X
a
M
M
M
Q
Q
Q
Q
Q
Q
Q
Q
Q
Q
Q
Q
Q
Q
Q
Q
L
Q
Q
Q
Q
H
H
Q
Q
a
X
W
W
W
W
W
"}
(57,1,1) = {"
W
W
X
a
a
M
M
Q
Q
Q
Q
Q
V
Q
Q
Q
M
Q
Q
Q
Q
L
Q
Q
Q
Q
Q
Q
Q
Q
Q
Q
a
a
X
X
W
W
W
W
"}
(58,1,1) = {"
W
W
X
a
M
M
M
M
Q
L
Q
Q
Q
Q
Q
Q
M
M
M
M
Q
Q
Q
Q
Q
Q
k
Q
Q
d
Q
a
a
X
X
X
W
W
W
W
"}
(59,1,1) = {"
W
W
X
a
N
M
M
M
Q
Q
Q
Q
Q
Q
Q
a
M
M
M
M
Q
Q
Q
Q
Q
Q
Q
Q
Q
H
U
a
a
X
X
X
W
W
W
W
"}
(60,1,1) = {"
W
W
X
a
M
M
M
Q
Q
Q
Q
Q
Q
a
a
Q
M
M
M
M
Q
Q
a
a
a
a
Q
Q
H
U
H
H
a
a
X
X
W
W
W
W
"}
(61,1,1) = {"
W
W
X
a
a
M
M
M
Q
Q
Q
Q
Q
Q
a
M
M
M
Q
Q
Q
a
a
Q
Q
a
Q
Q
H
U
H
H
H
a
X
X
W
W
W
W
"}
(62,1,1) = {"
W
W
X
X
a
M
M
M
Q
Q
Q
Q
w
Q
Q
M
M
Q
Q
G
Q
a
Q
Q
Q
Q
Q
Q
U
U
H
H
a
a
X
X
X
W
W
W
"}
(63,1,1) = {"
W
W
X
X
a
a
M
M
Q
Q
Q
Q
Q
Q
Q
Q
Q
Q
Q
Q
Q
Q
Q
Q
Q
Q
M
Q
B
Q
U
U
a
X
X
X
X
W
W
W
"}
(64,1,1) = {"
W
W
W
X
X
a
M
M
Q
Q
Q
Z
Q
Q
Q
Q
Q
M
Q
Q
Q
Q
Q
Q
Q
M
f
Q
Q
Q
Q
Q
a
a
a
X
X
W
W
W
"}
(65,1,1) = {"
W
W
W
X
X
a
M
M
Q
Q
Q
Q
Q
Q
B
Q
M
M
Q
Q
Q
Q
Q
Q
M
M
M
M
Q
Q
Q
Q
a
a
a
a
X
W
W
W
"}
(66,1,1) = {"
W
W
W
a
a
a
M
M
M
Q
Q
Q
Q
Q
Q
M
M
M
Q
Q
Q
w
M
M
M
M
s
M
a
a
a
a
a
a
a
a
X
W
W
W
"}
(67,1,1) = {"
W
W
X
a
a
a
a
a
U
U
U
Q
Q
Q
Q
M
M
Q
Q
Q
Q
w
M
M
M
U
M
a
a
a
a
a
a
a
a
X
X
W
W
W
"}
(68,1,1) = {"
W
W
X
a
a
a
a
a
a
U
U
Q
Q
Q
Q
Q
Q
Q
Q
Q
Q
Q
Q
Q
a
a
a
a
a
a
a
a
a
a
a
X
W
W
W
W
"}
(69,1,1) = {"
W
W
X
a
a
a
a
a
a
a
U
Q
Q
G
Q
Q
Q
Q
Q
a
a
a
a
a
a
a
a
a
a
a
a
a
a
a
X
X
W
W
W
W
"}
(70,1,1) = {"
W
W
W
X
a
a
a
a
a
a
a
a
Q
Q
Q
Q
d
a
a
a
X
X
a
a
a
a
a
a
a
a
a
a
X
X
X
W
W
W
W
W
"}
(71,1,1) = {"
W
W
W
X
X
a
a
a
a
a
a
a
a
a
a
a
a
a
X
X
X
X
X
X
X
X
a
a
X
X
X
X
X
X
X
W
W
W
W
W
"}
(72,1,1) = {"
W
W
W
W
W
X
X
a
a
a
a
a
X
X
X
X
X
X
X
X
X
X
X
X
X
X
X
X
X
X
X
X
X
X
W
W
W
W
W
W
"}
(73,1,1) = {"
W
W
W
W
W
W
X
X
X
X
X
X
X
X
X
X
X
X
X
X
X
X
X
X
X
X
X
X
X
X
X
X
W
W
W
W
W
W
W
W
"}
(74,1,1) = {"
W
W
W
W
W
W
W
X
X
X
X
X
X
X
X
X
X
X
X
X
X
X
W
W
W
W
W
W
W
W
W
W
W
W
W
W
W
W
W
W
"}
(75,1,1) = {"
W
W
W
W
W
W
W
W
W
W
W
W
W
W
W
W
W
W
W
W
W
W
W
W
W
W
W
W
W
W
W
W
W
W
W
W
W
W
W
W
"}
