//MAP CONVERTED BY dmm2tgm.py THIS HEADER COMMENT PREVENTS RECONVERSION, DO NOT REMOVE
"a" = (
/turf/template_noop,
/area/template_noop)
"e" = (
/obj/structure/loot_pile/surface/bones,
/turf/simulated/floor/outdoors/grass/forest/turfpack/muriki,
/area/mine/explored/muriki/cave/deepdark)
"i" = (
/obj/item/dnainjector/random_verygood_labeled,
/turf/simulated/floor/outdoors/grass/forest/turfpack/muriki,
/area/mine/explored/muriki/cave/deepdark)
"k" = (
/turf/template_noop,
/area/mine/explored/muriki/cave/deepdark)
"n" = (
/turf/simulated/mineral/alt/turfpack/muriki,
/area/mine/explored/muriki/cave/deepdark)
"t" = (
/mob/living/simple_mob/vore/mantrap,
/turf/simulated/floor/outdoors/grass/forest/turfpack/muriki,
/area/mine/explored/muriki/cave/deepdark)
"z" = (
/turf/simulated/floor/outdoors/grass/forest/turfpack/muriki,
/area/mine/explored/muriki/cave/deepdark)
"F" = (
/obj/machinery/portable_atmospherics/hydroponics/soil,
/turf/simulated/floor/outdoors/grass/forest/turfpack/muriki,
/area/mine/explored/muriki/cave/deepdark)
"H" = (
/mob/living/simple_mob/vore/pitcher_plant,
/turf/simulated/floor/outdoors/grass/forest/turfpack/muriki,
/area/mine/explored/muriki/cave/deepdark)
"J" = (
/obj/item/storage/firstaid/bonemed,
/turf/simulated/floor/outdoors/grass/forest/turfpack/muriki,
/area/mine/explored/muriki/cave/deepdark)
"N" = (
/mob/living/simple_mob/vore/pitcher,
/turf/simulated/floor/outdoors/grass/forest/turfpack/muriki,
/area/mine/explored/muriki/cave/deepdark)
"P" = (
/obj/structure/closet/crate/mimic/cointoss,
/obj/random/contraband,
/turf/simulated/floor/outdoors/grass/forest/turfpack/muriki,
/area/mine/explored/muriki/cave/deepdark)
"R" = (
/obj/item/bone,
/obj/item/bone,
/obj/item/bone,
/obj/item/bone/skull/unknown,
/turf/simulated/floor/outdoors/grass/forest/turfpack/muriki,
/area/mine/explored/muriki/cave/deepdark)
"Y" = (
/turf/simulated/mineral/alt/ignore_cavegen/turfpack/muriki,
/area/mine/explored/muriki/cave/deepdark)
"Z" = (
/obj/item/dnainjector/random,
/turf/simulated/floor/outdoors/grass/forest/turfpack/muriki,
/area/mine/explored/muriki/cave/deepdark)

(1,1,1) = {"
a
a
a
a
a
a
a
a
a
a
a
a
a
"}
(2,1,1) = {"
a
a
n
n
n
n
z
k
n
n
n
a
a
"}
(3,1,1) = {"
a
n
n
Y
Y
z
z
z
Y
Y
Y
n
a
"}
(4,1,1) = {"
a
n
Y
Y
Z
z
N
z
z
F
Y
n
a
"}
(5,1,1) = {"
a
n
F
z
t
z
z
z
Y
z
Y
n
a
"}
(6,1,1) = {"
a
n
z
z
z
z
z
z
z
z
Y
k
a
"}
(7,1,1) = {"
a
z
z
Y
z
Y
z
t
z
z
z
z
a
"}
(8,1,1) = {"
a
k
z
Y
z
e
z
z
z
Y
z
n
a
"}
(9,1,1) = {"
a
n
z
z
z
z
R
i
z
z
H
n
a
"}
(10,1,1) = {"
a
n
Y
z
t
z
F
z
z
z
Y
n
a
"}
(11,1,1) = {"
a
n
Y
z
z
z
z
z
z
z
z
n
a
"}
(12,1,1) = {"
a
n
Y
N
z
z
z
H
z
z
Y
n
a
"}
(13,1,1) = {"
a
n
Y
Y
z
z
z
z
z
P
Y
n
a
"}
(14,1,1) = {"
a
n
n
Y
Y
J
F
F
z
Y
Y
n
a
"}
(15,1,1) = {"
a
a
n
n
n
n
n
n
n
n
n
a
a
"}
(16,1,1) = {"
a
a
a
a
a
a
a
a
a
a
a
a
a
"}
