//MAP CONVERTED BY dmm2tgm.py THIS HEADER COMMENT PREVENTS RECONVERSION, DO NOT REMOVE
"a" = (
/turf/template_noop,
/area/template_noop)
"e" = (
/turf/simulated/mineral/alt/ignore_mapgen/turfpack/muriki,
/area/mine/unexplored/muriki/cave/deepdark)
"B" = (
/turf/simulated/mineral/floor/ignore_cavegen/turfpack/muriki,
/area/mine/explored/muriki/cave/deepdark)
"U" = (
/obj/effect/map_effect/interval/shifting_cave/muriki,
/turf/simulated/mineral/floor/ignore_cavegen/turfpack/muriki,
/area/mine/explored/muriki/cave/deepdark)
"Y" = (
/turf/simulated/mineral/alt/ignore_mapgen/turfpack/muriki,
/area/mine/explored/muriki/cave/deepdark)

(1,1,1) = {"
a
a
a
a
a
a
a
a
"}
(2,1,1) = {"
a
B
B
B
B
B
e
a
"}
(3,1,1) = {"
a
e
Y
B
B
Y
Y
a
"}
(4,1,1) = {"
a
Y
Y
B
B
B
Y
a
"}
(5,1,1) = {"
a
Y
B
B
B
B
Y
a
"}
(6,1,1) = {"
a
Y
U
B
B
U
Y
a
"}
(7,1,1) = {"
a
Y
U
U
U
Y
Y
a
"}
(8,1,1) = {"
a
Y
U
U
U
Y
Y
a
"}
(9,1,1) = {"
a
Y
Y
U
U
U
Y
a
"}
(10,1,1) = {"
a
Y
B
B
B
B
Y
a
"}
(11,1,1) = {"
a
Y
B
B
B
Y
Y
a
"}
(12,1,1) = {"
a
Y
Y
B
B
Y
Y
a
"}
(13,1,1) = {"
a
Y
Y
B
B
Y
e
a
"}
(14,1,1) = {"
a
e
B
B
B
B
e
a
"}
(15,1,1) = {"
a
a
a
a
a
a
a
a
"}
