//MAP CONVERTED BY dmm2tgm.py THIS HEADER COMMENT PREVENTS RECONVERSION, DO NOT REMOVE
"a" = (
/turf/simulated/mineral/alt/ignore_mapgen/turfpack/muriki,
/area/mine/unexplored/muriki/cave/deepdark)
"f" = (
/turf/template_noop,
/area/template_noop)
"h" = (
/turf/simulated/mineral/floor/ignore_cavegen/turfpack/muriki,
/area/mine/explored/muriki/cave/deepdark)
"R" = (
/turf/simulated/mineral/alt/ignore_mapgen/turfpack/muriki,
/area/mine/explored/muriki/cave/deepdark)
"Y" = (
/obj/effect/map_effect/interval/shifting_cave/muriki,
/turf/simulated/mineral/floor/ignore_cavegen/turfpack/muriki,
/area/mine/explored/muriki/cave/deepdark)

(1,1,1) = {"
f
f
f
f
f
f
f
f
f
f
f
f
f
f
f
"}
(2,1,1) = {"
f
R
a
R
R
a
a
R
R
R
R
a
a
R
f
"}
(3,1,1) = {"
f
h
R
h
h
R
R
Y
Y
h
h
R
R
h
f
"}
(4,1,1) = {"
f
h
h
h
h
Y
Y
Y
h
h
h
h
h
h
f
"}
(5,1,1) = {"
f
h
h
h
Y
Y
Y
Y
h
h
h
h
h
h
f
"}
(6,1,1) = {"
f
h
R
h
R
R
R
Y
Y
R
h
R
R
R
f
"}
(7,1,1) = {"
f
R
R
R
R
a
a
R
R
R
R
a
a
R
f
"}
(8,1,1) = {"
f
f
f
f
f
f
f
f
f
f
f
f
f
f
f
"}
