//MAP CONVERTED BY dmm2tgm.py THIS HEADER COMMENT PREVENTS RECONVERSION, DO NOT REMOVE
"a" = (
/turf/simulated/mineral/alt/ignore_mapgen/turfpack/muriki,
/area/mine/unexplored/muriki/cave/deepdark)
"g" = (
/turf/simulated/mineral/floor/ignore_cavegen/turfpack/muriki,
/area/mine/unexplored/muriki/cave/deepdark)
"j" = (
/turf/template_noop,
/area/template_noop)
"n" = (
/turf/template_noop,
/area/mine/unexplored/muriki/cave/deepdark)
"E" = (
/obj/effect/map_effect/interval/shifting_cave/muriki,
/turf/simulated/mineral/floor/ignore_cavegen/turfpack/muriki,
/area/mine/explored/muriki/cave/deepdark)
"O" = (
/turf/simulated/mineral/alt/ignore_mapgen/turfpack/muriki,
/area/mine/explored/muriki/cave/deepdark)
"Q" = (
/turf/simulated/mineral/floor/ignore_cavegen/turfpack/muriki,
/area/mine/explored/muriki/cave/deepdark)

(1,1,1) = {"
j
j
j
j
j
j
j
j
j
j
j
j
"}
(2,1,1) = {"
j
n
a
a
a
a
a
a
a
a
n
j
"}
(3,1,1) = {"
j
a
O
O
O
O
O
O
O
O
a
j
"}
(4,1,1) = {"
j
a
O
E
E
E
E
Q
O
O
a
j
"}
(5,1,1) = {"
j
g
Q
Q
E
E
Q
Q
Q
Q
g
j
"}
(6,1,1) = {"
j
n
Q
Q
Q
E
E
Q
Q
Q
g
j
"}
(7,1,1) = {"
j
n
Q
Q
E
E
E
E
Q
Q
n
j
"}
(8,1,1) = {"
j
g
Q
Q
Q
E
E
E
Q
Q
g
j
"}
(9,1,1) = {"
j
a
O
Q
E
E
E
O
O
O
a
j
"}
(10,1,1) = {"
j
a
O
O
O
O
O
O
O
O
a
j
"}
(11,1,1) = {"
j
n
a
a
a
a
a
a
a
a
n
j
"}
(12,1,1) = {"
j
j
j
j
j
j
j
j
j
j
j
j
"}
