//MAP CONVERTED BY dmm2tgm.py THIS HEADER COMMENT PREVENTS RECONVERSION, DO NOT REMOVE
"a" = (
/turf/simulated/mineral/floor/ignore_cavegen/turfpack/muriki,
/area/mine/unexplored/muriki/cave/deepdark)
"f" = (
/turf/template_noop,
/area/template_noop)
"r" = (
/turf/template_noop,
/area/mine/unexplored/muriki/cave/deepdark)

(1,1,1) = {"
f
f
f
f
f
f
f
f
f
f
f
f
f
f
f
f
f
f
f
f
f
f
f
f
f
f
f
f
f
f
"}
(2,1,1) = {"
f
r
r
r
r
r
r
r
r
r
r
r
r
r
r
r
r
r
r
r
r
r
r
r
r
r
r
r
r
f
"}
(3,1,1) = {"
f
r
r
r
a
a
a
r
r
r
r
r
r
r
a
a
a
r
r
r
r
r
r
r
r
r
r
r
r
f
"}
(4,1,1) = {"
f
r
a
a
a
a
a
a
a
r
r
a
a
a
a
a
a
a
r
r
r
a
a
a
a
a
r
r
r
f
"}
(5,1,1) = {"
f
r
a
a
a
a
a
a
a
a
a
a
a
a
a
a
a
a
a
a
a
a
a
a
a
a
a
r
r
f
"}
(6,1,1) = {"
f
a
a
a
a
a
a
a
a
a
a
a
a
a
a
a
a
a
a
a
a
a
a
a
a
a
a
r
r
f
"}
(7,1,1) = {"
f
a
a
a
a
a
a
a
a
a
a
a
a
a
a
a
a
a
a
a
a
a
a
a
a
a
a
a
r
f
"}
(8,1,1) = {"
f
a
a
a
a
a
a
a
a
a
a
a
a
a
a
a
a
a
a
a
a
a
a
a
a
a
a
a
r
f
"}
(9,1,1) = {"
f
r
a
a
a
a
a
a
a
a
a
a
a
a
a
a
a
a
a
a
a
a
a
a
a
a
a
a
r
f
"}
(10,1,1) = {"
f
r
a
a
a
a
a
a
a
a
a
a
a
a
a
a
a
a
a
a
a
a
a
a
a
a
a
r
r
f
"}
(11,1,1) = {"
f
r
a
a
a
a
a
a
a
a
a
a
a
a
a
a
a
a
a
a
a
a
a
a
a
a
r
r
r
f
"}
(12,1,1) = {"
f
r
r
r
a
a
a
a
a
a
a
r
r
r
a
a
a
a
a
a
r
r
a
a
r
r
r
r
r
f
"}
(13,1,1) = {"
f
r
r
r
r
a
a
a
r
r
r
r
r
r
r
r
r
r
r
r
r
r
r
r
r
r
r
r
r
f
"}
(14,1,1) = {"
f
r
r
r
r
r
r
r
r
r
r
r
r
r
r
r
r
r
r
r
r
r
r
r
r
r
r
r
r
f
"}
(15,1,1) = {"
f
f
f
f
f
f
f
f
f
f
f
f
f
f
f
f
f
f
f
f
f
f
f
f
f
f
f
f
f
f
"}
