//MAP CONVERTED BY dmm2tgm.py THIS HEADER COMMENT PREVENTS RECONVERSION, DO NOT REMOVE
"a" = (
/turf/template_noop,
/area/mine/unexplored/muriki/cave/deepdark)
"t" = (
/turf/template_noop,
/area/template_noop)
"B" = (
/turf/simulated/mineral/floor/ignore_cavegen/turfpack/muriki,
/area/mine/unexplored/muriki/cave/deepdark)

(1,1,1) = {"
t
t
t
t
t
t
t
t
t
t
t
t
t
t
t
"}
(2,1,1) = {"
t
a
a
a
a
a
B
B
B
a
a
a
a
a
t
"}
(3,1,1) = {"
t
a
a
a
a
B
B
B
B
B
B
a
a
a
t
"}
(4,1,1) = {"
t
a
a
a
B
B
B
B
B
B
B
a
a
a
t
"}
(5,1,1) = {"
t
a
a
B
B
B
B
B
B
B
B
B
a
a
t
"}
(6,1,1) = {"
t
a
a
B
B
B
B
B
B
B
B
B
a
a
t
"}
(7,1,1) = {"
t
a
a
B
B
B
B
B
B
B
B
B
a
a
t
"}
(8,1,1) = {"
t
a
a
B
B
B
B
B
B
B
B
B
a
a
t
"}
(9,1,1) = {"
t
a
a
a
B
B
B
B
B
B
B
a
a
a
t
"}
(10,1,1) = {"
t
a
a
a
B
B
B
B
B
B
B
a
a
a
t
"}
(11,1,1) = {"
t
a
a
a
B
B
B
B
B
B
B
a
a
a
t
"}
(12,1,1) = {"
t
a
a
B
B
B
B
B
B
B
B
B
a
a
t
"}
(13,1,1) = {"
t
a
a
B
B
B
B
B
B
B
B
B
a
a
t
"}
(14,1,1) = {"
t
a
a
B
B
B
B
B
B
B
B
B
a
a
t
"}
(15,1,1) = {"
t
a
a
B
B
B
B
B
B
B
B
B
a
a
t
"}
(16,1,1) = {"
t
a
a
B
B
B
B
B
B
B
B
B
a
a
t
"}
(17,1,1) = {"
t
a
a
B
B
B
B
B
B
B
B
B
a
a
t
"}
(18,1,1) = {"
t
a
a
B
B
B
B
B
B
B
B
B
a
a
t
"}
(19,1,1) = {"
t
a
a
a
B
B
B
B
B
B
B
B
a
a
t
"}
(20,1,1) = {"
t
a
a
a
B
B
B
B
B
B
B
a
a
a
t
"}
(21,1,1) = {"
t
a
a
a
B
B
B
B
B
B
B
a
a
a
t
"}
(22,1,1) = {"
t
a
a
B
B
B
B
B
B
B
B
a
a
a
t
"}
(23,1,1) = {"
t
a
a
B
B
B
B
B
B
B
B
B
a
a
t
"}
(24,1,1) = {"
t
a
a
a
B
B
B
B
B
B
B
B
a
a
t
"}
(25,1,1) = {"
t
a
a
a
B
B
B
B
B
B
B
B
a
a
t
"}
(26,1,1) = {"
t
a
a
a
B
B
B
B
B
B
B
B
a
a
t
"}
(27,1,1) = {"
t
a
a
a
a
B
B
B
B
B
B
a
a
a
t
"}
(28,1,1) = {"
t
a
a
a
a
B
B
B
B
B
B
a
a
a
t
"}
(29,1,1) = {"
t
a
a
a
a
a
B
B
B
a
a
a
a
a
t
"}
(30,1,1) = {"
t
t
t
t
t
t
t
t
t
t
t
t
t
t
t
"}
