//MAP CONVERTED BY dmm2tgm.py THIS HEADER COMMENT PREVENTS RECONVERSION, DO NOT REMOVE
"a" = (
/turf/template_noop,
/area/template_noop)
"t" = (
/turf/simulated/mineral/floor/ignore_cavegen/turfpack/muriki,
/area/mine/explored/muriki/cave/deepdark)
"K" = (
/turf/simulated/floor/plating/turfpack/muriki,
/area/mine/explored/muriki/cave/deepdark)
"M" = (
/obj/item/paper/card/heart{
	name = "Go Home Hole";
	desc = "A paper card with a heart on the cover.";
	info = "Go home friend! Happy home go in hole! Home in hole! Hole is happy home!"
	},
/turf/simulated/floor/plating/turfpack/muriki,
/area/mine/explored/muriki/cave/deepdark)
"R" = (
/turf/template_noop,
/area/mine/explored/muriki/cave/deepdark)
"X" = (
/obj/effect/floor_decal/steeldecal/steel_decals_central2{
	pixel_y = 1
	},
/turf/simulated/deathdrop/liminal_home_pit,
/area/mine/explored/muriki/cave/deepdark)

(1,1,1) = {"
a
a
a
a
a
a
a
"}
(2,1,1) = {"
a
R
t
t
t
R
a
"}
(3,1,1) = {"
a
t
K
K
K
t
a
"}
(4,1,1) = {"
a
t
K
X
M
t
a
"}
(5,1,1) = {"
a
t
K
K
K
t
a
"}
(6,1,1) = {"
a
R
t
t
t
R
a
"}
(7,1,1) = {"
a
a
a
a
a
a
a
"}
