//MAP CONVERTED BY dmm2tgm.py THIS HEADER COMMENT PREVENTS RECONVERSION, DO NOT REMOVE
"a" = (
/turf/simulated/mineral/floor/ignore_cavegen/turfpack/muriki,
/area/mine/explored/muriki/cave/deepdark)
"e" = (
/turf/simulated/floor/water/acidic/shoreline/corner/corner_cave/indoor/turfpack/muriki{
	dir = 1
	},
/area/mine/explored/muriki/cave/deepdark)
"f" = (
/turf/template_noop,
/area/template_noop)
"h" = (
/turf/simulated/floor/water/acidic/shoreline/corner/corner_cave/indoor/turfpack/muriki{
	dir = 8
	},
/area/mine/explored/muriki/cave/deepdark)
"i" = (
/turf/simulated/floor/water/acidic/shoreline/shoreline_cave/indoor/turfpack/muriki{
	dir = 1
	},
/area/mine/explored/muriki/cave/deepdark)
"o" = (
/turf/template_noop,
/area/mine/unexplored/muriki/cave/deepdark)
"r" = (
/turf/simulated/floor/water/acidic/shoreline/shoreline_cave/indoor/turfpack/muriki{
	dir = 8
	},
/area/mine/explored/muriki/cave/deepdark)
"s" = (
/turf/simulated/floor/water/acidic/deep,
/area/mine/explored/muriki/cave/deepdark)
"u" = (
/turf/simulated/mineral/floor/ignore_cavegen/turfpack/muriki,
/area/mine/unexplored/muriki/cave/deepdark)
"w" = (
/turf/simulated/floor/water/acidic/shoreline/corner/corner_cave/indoor/turfpack/muriki{
	dir = 4
	},
/area/mine/explored/muriki/cave/deepdark)
"B" = (
/turf/simulated/floor/water/acidic/shoreline/shoreline_cave/indoor/turfpack/muriki{
	dir = 10
	},
/area/mine/explored/muriki/cave/deepdark)
"E" = (
/turf/simulated/floor/water/acidic/indoor/turfpack/muriki,
/area/mine/explored/muriki/cave/deepdark)
"G" = (
/turf/simulated/floor/water/acidic/shoreline/shoreline_cave/indoor/turfpack/muriki{
	dir = 9
	},
/area/mine/explored/muriki/cave/deepdark)
"K" = (
/turf/simulated/floor/water/acidic/shoreline/corner/corner_cave/indoor/turfpack/muriki,
/area/mine/explored/muriki/cave/deepdark)
"N" = (
/turf/simulated/floor/water/acidic/shoreline/shoreline_cave/indoor/turfpack/muriki{
	dir = 5
	},
/area/mine/explored/muriki/cave/deepdark)
"S" = (
/turf/simulated/floor/water/acidic/shoreline/shoreline_cave/indoor/turfpack/muriki,
/area/mine/explored/muriki/cave/deepdark)
"X" = (
/turf/simulated/floor/water/acidic/shoreline/shoreline_cave/indoor/turfpack/muriki{
	dir = 6
	},
/area/mine/explored/muriki/cave/deepdark)
"Z" = (
/turf/simulated/floor/water/acidic/shoreline/shoreline_cave/indoor/turfpack/muriki{
	dir = 4
	},
/area/mine/explored/muriki/cave/deepdark)

(1,1,1) = {"
f
f
f
f
f
f
f
f
f
f
f
f
f
f
f
f
f
f
f
f
f
f
f
f
f
f
f
f
f
f
f
f
f
f
f
"}
(2,1,1) = {"
f
o
o
o
o
o
o
o
o
o
o
o
o
o
o
o
o
o
o
o
o
o
o
o
o
o
o
o
o
o
o
o
o
o
f
"}
(3,1,1) = {"
f
o
o
o
o
o
o
o
o
o
o
o
o
o
o
o
o
o
o
o
o
o
o
o
o
o
o
o
o
o
o
o
o
o
f
"}
(4,1,1) = {"
f
o
o
o
o
o
o
o
o
o
o
o
o
o
o
o
o
o
o
o
u
u
o
o
o
o
o
o
o
o
o
o
o
o
f
"}
(5,1,1) = {"
f
o
o
o
o
u
u
u
o
o
o
o
o
o
o
o
o
u
u
u
u
u
u
o
o
o
o
o
o
o
o
o
o
o
f
"}
(6,1,1) = {"
f
o
o
o
u
u
u
u
u
o
o
o
o
u
a
a
a
a
a
a
u
u
u
u
o
o
o
o
u
u
o
o
o
o
f
"}
(7,1,1) = {"
f
o
o
u
u
u
u
u
u
o
o
u
u
a
a
a
a
a
a
a
a
a
u
u
o
o
o
u
u
u
o
o
o
o
f
"}
(8,1,1) = {"
f
o
o
u
u
u
u
u
u
u
u
u
a
a
a
K
r
r
h
a
a
a
a
a
a
a
a
u
u
u
u
o
o
o
f
"}
(9,1,1) = {"
f
o
o
u
u
u
u
u
u
u
u
u
a
a
a
S
E
E
N
h
a
a
a
a
a
a
a
a
u
u
u
o
o
o
f
"}
(10,1,1) = {"
f
o
o
u
u
u
u
u
u
u
u
a
a
a
a
S
E
E
E
N
r
h
a
a
a
a
a
a
a
a
u
o
o
o
f
"}
(11,1,1) = {"
f
o
o
o
u
u
u
u
u
u
u
a
a
a
K
X
E
E
E
E
E
N
h
a
a
a
a
a
a
a
u
u
o
o
f
"}
(12,1,1) = {"
f
o
o
o
u
u
u
u
u
u
a
a
a
a
S
E
E
E
E
E
E
E
i
a
a
a
a
a
a
a
u
u
o
o
f
"}
(13,1,1) = {"
f
o
o
o
u
u
u
u
u
u
a
a
a
K
X
E
E
E
s
E
E
E
N
r
h
a
a
a
a
a
a
u
o
o
f
"}
(14,1,1) = {"
f
o
o
o
u
u
u
u
u
u
a
a
a
S
E
E
E
s
s
s
E
E
E
E
N
r
h
a
a
a
a
u
o
o
f
"}
(15,1,1) = {"
f
o
o
o
o
u
u
u
u
u
a
a
a
S
E
E
E
s
s
s
E
E
E
E
E
E
N
h
a
a
a
u
o
o
f
"}
(16,1,1) = {"
f
o
o
o
o
u
u
u
u
a
a
a
a
S
E
E
E
s
s
s
s
s
E
E
E
E
E
i
a
a
a
o
o
o
f
"}
(17,1,1) = {"
f
o
o
o
o
u
u
u
u
a
a
a
a
S
E
E
E
s
s
s
s
s
s
E
E
E
E
i
a
a
a
o
o
o
f
"}
(18,1,1) = {"
f
o
o
o
o
u
u
u
u
a
a
a
K
X
E
E
s
s
s
s
s
s
s
s
E
E
E
i
a
a
o
o
o
o
f
"}
(19,1,1) = {"
f
o
o
o
o
u
u
u
u
a
a
a
S
E
E
E
s
s
s
s
s
s
s
s
E
E
G
w
a
a
o
o
o
o
f
"}
(20,1,1) = {"
f
o
o
o
u
u
u
u
u
a
a
a
S
E
E
E
s
s
s
s
s
s
s
E
E
E
i
a
a
a
a
o
o
o
f
"}
(21,1,1) = {"
f
o
o
u
u
u
u
u
u
a
a
a
S
E
E
E
E
E
s
s
s
s
s
E
E
E
i
a
a
a
a
o
o
o
f
"}
(22,1,1) = {"
f
o
o
u
u
u
u
u
u
a
a
a
S
E
E
E
E
E
s
s
s
s
E
E
E
E
i
a
a
a
a
u
o
o
f
"}
(23,1,1) = {"
f
o
o
u
u
u
u
u
u
a
a
a
e
B
E
E
E
E
E
E
E
E
E
E
E
G
w
a
a
a
a
u
u
o
f
"}
(24,1,1) = {"
f
o
o
u
u
u
u
u
u
a
a
a
a
e
B
E
E
E
E
E
E
E
E
E
E
i
a
a
a
a
u
u
u
o
f
"}
(25,1,1) = {"
f
o
o
u
u
u
u
u
u
a
a
a
a
a
e
Z
Z
B
E
E
E
E
E
G
Z
w
a
a
a
a
u
o
o
o
f
"}
(26,1,1) = {"
f
o
o
o
u
u
u
u
u
a
a
a
a
a
a
a
a
e
Z
Z
Z
Z
Z
w
a
a
a
a
a
u
u
o
o
o
f
"}
(27,1,1) = {"
f
o
o
o
u
u
u
u
u
u
a
a
a
a
a
a
a
a
a
a
a
a
a
a
a
a
a
a
a
u
u
o
o
o
f
"}
(28,1,1) = {"
f
o
o
o
u
u
u
u
u
u
a
a
a
a
a
a
a
a
a
a
a
a
a
a
a
a
a
u
u
u
u
o
o
o
f
"}
(29,1,1) = {"
f
o
o
o
o
u
u
u
u
u
u
u
u
u
a
a
a
a
a
a
a
a
a
a
u
u
u
u
u
u
o
o
o
o
f
"}
(30,1,1) = {"
f
o
o
o
o
o
u
u
u
u
u
u
u
u
u
u
u
u
u
u
u
u
u
u
u
u
u
u
u
u
o
o
o
o
f
"}
(31,1,1) = {"
f
o
o
o
o
o
o
u
u
u
o
o
o
o
o
u
u
o
o
u
u
u
u
u
u
u
u
u
u
u
o
o
o
o
f
"}
(32,1,1) = {"
f
o
o
o
o
o
o
o
o
o
o
o
o
o
o
o
o
o
o
o
u
u
u
u
u
u
u
o
o
o
o
o
o
o
f
"}
(33,1,1) = {"
f
o
o
o
o
o
o
o
o
o
o
o
o
o
o
o
o
o
o
o
o
o
o
o
o
o
o
o
o
o
o
o
o
o
f
"}
(34,1,1) = {"
f
o
o
o
o
o
o
o
o
o
o
o
o
o
o
o
o
o
o
o
o
o
o
o
o
o
o
o
o
o
o
o
o
o
f
"}
(35,1,1) = {"
f
f
f
f
f
f
f
f
f
f
f
f
f
f
f
f
f
f
f
f
f
f
f
f
f
f
f
f
f
f
f
f
f
f
f
"}
