//MAP CONVERTED BY dmm2tgm.py THIS HEADER COMMENT PREVENTS RECONVERSION, DO NOT REMOVE
"a" = (
/turf/simulated/mineral/floor/ignore_cavegen/turfpack/muriki,
/area/mine/explored/muriki/cave/deepdark)
"b" = (
/turf/simulated/floor/lava/turfpack/muriki,
/area/mine/explored/muriki/cave/deepdark)
"K" = (
/turf/template_noop,
/area/template_noop)
"M" = (
/turf/template_noop,
/area/mine/explored/muriki/cave/deepdark)

(1,1,1) = {"
K
K
K
K
K
K
K
K
K
K
K
K
K
K
K
K
K
K
K
K
"}
(2,1,1) = {"
K
M
M
M
M
M
M
M
M
M
M
M
M
M
M
M
M
M
M
K
"}
(3,1,1) = {"
K
M
M
M
M
M
M
M
M
M
M
M
M
M
M
M
M
M
M
K
"}
(4,1,1) = {"
K
M
M
M
M
M
M
M
a
a
a
a
a
M
M
M
M
M
M
K
"}
(5,1,1) = {"
K
M
M
a
a
a
a
a
a
a
a
a
a
a
a
a
M
M
M
K
"}
(6,1,1) = {"
K
M
a
a
a
a
a
a
a
b
b
b
b
a
a
a
a
M
M
K
"}
(7,1,1) = {"
K
M
a
a
a
a
b
b
b
b
b
b
b
b
a
a
a
M
M
K
"}
(8,1,1) = {"
K
M
a
a
a
b
b
b
b
b
b
b
b
b
b
a
a
M
M
K
"}
(9,1,1) = {"
K
M
a
a
b
b
b
b
b
b
b
b
b
b
b
a
a
a
M
K
"}
(10,1,1) = {"
K
M
a
b
b
b
b
b
b
b
b
b
b
b
b
b
a
a
M
K
"}
(11,1,1) = {"
K
M
a
b
b
b
b
b
b
b
b
b
b
b
b
b
b
a
M
K
"}
(12,1,1) = {"
K
M
a
b
b
b
b
b
b
b
b
b
b
b
b
b
b
a
M
K
"}
(13,1,1) = {"
K
M
a
a
b
b
b
b
b
b
b
b
b
b
b
b
b
a
a
K
"}
(14,1,1) = {"
K
M
a
a
a
b
b
b
b
a
b
b
b
b
b
b
b
a
a
K
"}
(15,1,1) = {"
K
M
a
a
a
a
b
b
b
a
a
b
b
b
b
b
a
a
a
K
"}
(16,1,1) = {"
K
M
M
a
a
a
a
a
a
a
a
a
a
a
a
a
a
a
M
K
"}
(17,1,1) = {"
K
M
M
a
a
a
a
M
M
M
M
a
a
a
a
a
a
a
M
K
"}
(18,1,1) = {"
K
M
M
M
M
M
M
M
M
M
M
M
M
M
a
a
a
a
M
K
"}
(19,1,1) = {"
K
M
M
M
M
M
M
M
M
M
M
M
M
M
M
M
M
M
M
K
"}
(20,1,1) = {"
K
K
K
K
K
K
K
K
K
K
K
K
K
K
K
K
K
K
K
K
"}
