//MAP CONVERTED BY dmm2tgm.py THIS HEADER COMMENT PREVENTS RECONVERSION, DO NOT REMOVE
"a" = (
/turf/simulated/mineral/floor/ignore_cavegen/turfpack/muriki,
/area/mine/explored/muriki/cave/deepdark)
"d" = (
/turf/template_noop,
/area/template_noop)
"f" = (
/turf/template_noop,
/area/mine/explored/muriki/cave/deepdark)
"S" = (
/turf/simulated/floor/lava/turfpack/muriki,
/area/mine/explored/muriki/cave/deepdark)

(1,1,1) = {"
d
d
d
d
d
d
d
d
d
d
d
d
d
d
d
"}
(2,1,1) = {"
d
f
f
f
f
f
f
f
f
f
f
f
f
f
d
"}
(3,1,1) = {"
d
f
f
f
f
f
f
f
f
f
f
f
f
f
d
"}
(4,1,1) = {"
d
f
f
a
a
a
a
a
a
a
a
f
f
f
d
"}
(5,1,1) = {"
d
f
f
a
a
a
S
S
S
S
a
a
f
f
d
"}
(6,1,1) = {"
d
f
a
a
a
S
S
S
S
S
S
a
a
f
d
"}
(7,1,1) = {"
d
f
a
a
S
S
S
S
S
S
S
S
a
f
d
"}
(8,1,1) = {"
d
f
a
S
S
S
S
S
S
S
S
S
a
f
d
"}
(9,1,1) = {"
d
f
a
S
S
S
S
S
S
S
S
S
a
f
d
"}
(10,1,1) = {"
d
f
a
a
S
S
S
S
S
S
S
a
a
f
d
"}
(11,1,1) = {"
d
f
a
a
S
S
S
S
S
S
a
a
a
f
d
"}
(12,1,1) = {"
d
f
a
a
S
S
S
S
S
a
a
a
f
f
d
"}
(13,1,1) = {"
d
f
a
a
a
a
a
a
a
f
f
f
f
f
d
"}
(14,1,1) = {"
d
f
f
f
f
f
f
f
f
f
f
f
f
f
d
"}
(15,1,1) = {"
d
d
d
d
d
d
d
d
d
d
d
d
d
d
d
"}
