//MAP CONVERTED BY dmm2tgm.py THIS HEADER COMMENT PREVENTS RECONVERSION, DO NOT REMOVE
"a" = (
/turf/template_noop,
/area/mine/unexplored/muriki/cave/deepdark)
"b" = (
/obj/structure/table/sifwooden_reinforced,
/obj/item/flashlight/lamp/green{
	pixel_y = 2;
	pixel_x = -8
	},
/turf/simulated/floor/tiled,
/area/submap/outpost21/cave_liminal_A)
"f" = (
/obj/structure/table/rack/shelf/wood,
/obj/random/meat,
/turf/simulated/floor/tiled,
/area/submap/outpost21/cave_liminal_A)
"g" = (
/obj/structure/bed/chair{
	dir = 8
	},
/turf/simulated/floor/tiled,
/area/submap/outpost21/cave_liminal_A)
"i" = (
/obj/machinery/door/airlock/maintenance/common,
/turf/simulated/floor/tiled/techfloor,
/area/submap/outpost21/cave_liminal_A)
"j" = (
/obj/structure/bed/chair,
/turf/simulated/floor/tiled,
/area/submap/outpost21/cave_liminal_A)
"n" = (
/obj/structure/table/rack/shelf/wood,
/obj/random/contraband,
/turf/simulated/floor/tiled,
/area/submap/outpost21/cave_liminal_A)
"o" = (
/turf/simulated/deathdrop/liminal,
/area/submap/outpost21/cave_liminal_A)
"p" = (
/obj/structure/table/rack/shelf/wood,
/obj/random/maintenance/medical,
/turf/simulated/floor/tiled,
/area/submap/outpost21/cave_liminal_A)
"s" = (
/obj/machinery/door/airlock/maintenance/common,
/turf/simulated/deathdrop/liminal,
/area/submap/outpost21/cave_liminal_A)
"u" = (
/turf/template_noop,
/area/template_noop)
"z" = (
/obj/structure/table/sifwooden_reinforced,
/obj/item/flashlight/lamp/green{
	pixel_y = 14
	},
/turf/simulated/floor/tiled,
/area/submap/outpost21/cave_liminal_A)
"A" = (
/obj/structure/table/sifwooden_reinforced,
/obj/item/flashlight/lamp/green{
	pixel_y = 12;
	pixel_x = -8
	},
/turf/simulated/floor/tiled,
/area/submap/outpost21/cave_liminal_A)
"C" = (
/obj/structure/table/sifwooden_reinforced,
/obj/item/flashlight/lamp/green{
	pixel_y = 2;
	pixel_x = 6
	},
/turf/simulated/floor/tiled,
/area/submap/outpost21/cave_liminal_A)
"E" = (
/obj/structure/bed/chair{
	dir = 4
	},
/turf/simulated/floor/tiled,
/area/submap/outpost21/cave_liminal_A)
"H" = (
/turf/simulated/floor/tiled,
/area/submap/outpost21/cave_liminal_A)
"I" = (
/obj/structure/bed/chair{
	dir = 1
	},
/turf/simulated/floor/tiled,
/area/submap/outpost21/cave_liminal_A)
"S" = (
/turf/simulated/wall,
/area/submap/outpost21/cave_liminal_A)
"T" = (
/turf/simulated/mineral/floor/ignore_cavegen/turfpack/muriki,
/area/mine/unexplored/muriki/cave/deepdark)
"Y" = (
/obj/structure/table/rack/shelf/wood,
/obj/random/maintenance,
/turf/simulated/floor/tiled,
/area/submap/outpost21/cave_liminal_A)

(1,1,1) = {"
u
u
u
u
u
u
u
u
u
u
u
u
u
u
u
u
u
u
u
u
u
u
u
u
u
"}
(2,1,1) = {"
u
a
a
a
a
a
a
T
T
T
a
a
T
T
a
S
S
S
S
a
a
a
a
a
u
"}
(3,1,1) = {"
u
a
a
a
T
S
S
S
i
S
S
S
i
S
S
S
z
H
S
T
a
a
a
a
u
"}
(4,1,1) = {"
u
a
a
T
T
i
H
H
H
p
S
H
H
j
b
S
g
H
i
T
T
T
T
a
u
"}
(5,1,1) = {"
u
a
a
a
T
S
A
I
H
H
S
Y
H
H
H
i
H
H
S
T
T
T
T
a
u
"}
(6,1,1) = {"
u
a
a
S
S
S
S
S
S
i
S
S
S
i
S
S
H
Y
S
S
S
i
S
a
u
"}
(7,1,1) = {"
u
a
a
i
H
H
j
b
S
H
n
S
f
H
S
S
i
S
S
S
z
H
S
a
u
"}
(8,1,1) = {"
u
a
a
S
Y
H
H
H
i
H
H
S
H
H
i
H
H
j
b
S
g
H
S
a
u
"}
(9,1,1) = {"
u
a
S
S
S
S
S
i
S
E
H
i
H
E
S
Y
H
H
H
i
H
H
S
a
u
"}
(10,1,1) = {"
u
T
S
z
H
S
Y
H
S
z
H
S
H
z
S
S
S
S
S
S
H
Y
S
a
u
"}
(11,1,1) = {"
u
T
S
g
H
i
H
H
S
S
S
S
S
S
S
S
S
S
S
S
i
S
S
a
u
"}
(12,1,1) = {"
u
T
i
H
H
S
H
E
S
o
s
H
H
E
C
S
H
p
S
n
H
S
a
a
u
"}
(13,1,1) = {"
u
T
S
H
p
S
H
z
S
o
S
f
H
H
H
i
H
H
i
H
H
S
T
a
u
"}
(14,1,1) = {"
u
a
S
i
S
S
i
S
S
S
S
S
S
i
S
S
E
H
S
H
E
i
T
T
u
"}
(15,1,1) = {"
u
a
T
T
S
A
I
H
H
i
H
n
S
H
z
S
z
H
S
H
z
S
T
T
u
"}
(16,1,1) = {"
u
a
a
T
S
H
H
H
Y
S
H
H
S
H
g
S
S
i
S
S
S
S
S
S
u
"}
(17,1,1) = {"
u
a
a
a
S
S
S
S
i
S
E
H
i
H
H
S
H
H
j
b
S
H
Y
S
u
"}
(18,1,1) = {"
u
S
S
S
S
S
S
z
H
S
z
H
S
Y
H
S
f
H
H
H
i
H
H
S
u
"}
(19,1,1) = {"
u
i
H
H
j
b
S
g
H
S
S
i
S
S
i
S
S
i
S
S
S
E
H
i
u
"}
(20,1,1) = {"
u
S
Y
H
H
H
i
H
H
S
T
T
S
z
H
S
T
T
T
T
S
z
H
S
u
"}
(21,1,1) = {"
u
S
S
S
i
S
S
H
n
S
a
T
S
g
H
S
T
T
T
a
S
S
i
S
u
"}
(22,1,1) = {"
u
a
a
T
T
T
S
i
S
S
a
T
i
H
H
S
T
a
a
a
T
T
T
a
u
"}
(23,1,1) = {"
u
a
a
a
T
a
T
T
T
a
a
T
S
H
p
S
a
a
a
a
a
T
T
a
u
"}
(24,1,1) = {"
u
a
a
a
a
a
a
T
a
a
a
a
S
i
S
S
a
a
a
a
a
a
a
a
u
"}
(25,1,1) = {"
u
u
u
u
u
u
u
u
u
u
u
u
u
u
u
u
u
u
u
u
u
u
u
u
u
"}
