//MAP CONVERTED BY dmm2tgm.py THIS HEADER COMMENT PREVENTS RECONVERSION, DO NOT REMOVE
"a" = (
/turf/template_noop,
/area/template_noop)
"e" = (
/obj/effect/landmark/redspaceexit,
/obj/structure/bed,
/obj/item/bedsheet/blue,
/turf/simulated/floor/tiled/turfpack/muriki,
/area/mine/explored/muriki/cave/deepdark)
"m" = (
/obj/structure/table/sifwooden_reinforced,
/obj/item/flashlight/lamp/green{
	pixel_y = 14
	},
/turf/simulated/floor/tiled/turfpack/muriki,
/area/mine/explored/muriki/cave/deepdark)
"u" = (
/turf/simulated/mineral/floor/ignore_cavegen/turfpack/muriki,
/area/mine/explored/muriki/cave/deepdark)
"y" = (
/obj/structure/table/rack/shelf/wood,
/obj/random/maintenance,
/turf/simulated/floor/tiled/turfpack/muriki,
/area/mine/explored/muriki/cave/deepdark)
"F" = (
/turf/simulated/floor/tiled/turfpack/muriki,
/area/mine/explored/muriki/cave/deepdark)
"G" = (
/turf/template_noop,
/area/mine/explored/muriki/cave/deepdark)
"N" = (
/obj/structure/simple_door/wood,
/turf/simulated/floor/tiled/techfloor/turfpack/muriki,
/area/mine/explored/muriki/cave/deepdark)
"P" = (
/turf/simulated/wall,
/area/mine/explored/muriki/cave/deepdark)
"S" = (
/obj/structure/bed/chair{
	dir = 4
	},
/turf/simulated/floor/tiled/turfpack/muriki,
/area/mine/explored/muriki/cave/deepdark)

(1,1,1) = {"
a
a
a
a
a
a
a
a
a
a
a
a
a
a
a
a
a
a
a
a
"}
(2,1,1) = {"
a
G
G
G
G
G
G
G
G
G
G
G
G
G
G
G
G
G
G
a
"}
(3,1,1) = {"
a
G
G
G
G
G
G
G
G
G
G
G
G
G
G
G
G
G
G
a
"}
(4,1,1) = {"
a
G
G
G
G
G
G
G
G
G
G
G
G
G
G
G
G
G
G
a
"}
(5,1,1) = {"
a
G
G
G
G
G
G
G
G
u
u
u
u
G
G
G
G
G
G
a
"}
(6,1,1) = {"
a
G
G
G
G
u
u
u
u
u
u
u
u
u
u
G
G
G
G
a
"}
(7,1,1) = {"
a
G
G
u
u
u
u
u
u
u
u
u
u
u
u
u
G
G
G
a
"}
(8,1,1) = {"
a
G
G
u
u
u
u
u
P
P
P
P
u
u
u
u
G
G
G
a
"}
(9,1,1) = {"
a
G
G
u
u
u
u
u
P
y
e
P
u
u
u
u
u
G
G
a
"}
(10,1,1) = {"
a
G
G
u
u
u
u
u
N
F
F
P
u
u
u
u
u
G
G
a
"}
(11,1,1) = {"
a
G
G
u
u
u
u
u
P
F
S
P
u
u
u
u
u
G
G
a
"}
(12,1,1) = {"
a
G
G
G
u
u
u
u
P
F
m
P
u
u
u
u
u
G
G
a
"}
(13,1,1) = {"
a
G
G
G
u
u
u
u
P
P
P
P
u
u
u
u
u
G
G
a
"}
(14,1,1) = {"
a
G
G
G
u
u
u
u
u
u
u
u
u
u
u
u
u
G
G
a
"}
(15,1,1) = {"
a
G
G
G
G
u
u
u
u
u
u
u
u
u
u
u
G
G
G
a
"}
(16,1,1) = {"
a
G
G
G
G
u
u
u
u
u
u
u
u
u
G
G
G
G
G
a
"}
(17,1,1) = {"
a
G
G
G
G
G
G
G
G
G
G
u
u
G
G
G
G
G
G
a
"}
(18,1,1) = {"
a
G
G
G
G
G
G
G
G
G
G
G
G
G
G
G
G
G
G
a
"}
(19,1,1) = {"
a
G
G
G
G
G
G
G
G
G
G
G
G
G
G
G
G
G
G
a
"}
(20,1,1) = {"
a
a
a
a
a
a
a
a
a
a
a
a
a
a
a
a
a
a
a
a
"}
