//MAP CONVERTED BY dmm2tgm.py THIS HEADER COMMENT PREVENTS RECONVERSION, DO NOT REMOVE
"a" = (
/turf/simulated/wall,
/area/mine/explored/muriki/cave/deepdark)
"e" = (
/turf/simulated/floor/tiled/techfloor/turfpack/muriki,
/area/mine/explored/muriki/cave/deepdark)
"i" = (
/obj/structure/table/rack/shelf/steel,
/turf/simulated/floor/tiled/turfpack/muriki,
/area/mine/explored/muriki/cave/deepdark)
"o" = (
/obj/machinery/door/airlock/multi_tile/glass{
	dir = 1
	},
/turf/simulated/floor/tiled/techfloor/turfpack/muriki,
/area/mine/explored/muriki/cave/deepdark)
"F" = (
/turf/template_noop,
/area/template_noop)
"J" = (
/turf/template_noop,
/area/mine/explored/muriki/cave/deepdark)
"N" = (
/obj/machinery/door/airlock/highsecurity,
/turf/simulated/floor/tiled/turfpack/muriki,
/area/mine/explored/muriki/cave/deepdark)
"U" = (
/turf/simulated/mineral/floor/ignore_cavegen/turfpack/muriki,
/area/mine/explored/muriki/cave/deepdark)
"V" = (
/obj/structure/table/standard,
/turf/simulated/floor/tiled/turfpack/muriki,
/area/mine/explored/muriki/cave/deepdark)
"Z" = (
/turf/simulated/floor/tiled/turfpack/muriki,
/area/mine/explored/muriki/cave/deepdark)

(1,1,1) = {"
F
F
F
F
F
F
F
F
F
F
F
F
F
F
F
F
F
F
F
F
F
F
F
F
F
F
F
F
F
F
"}
(2,1,1) = {"
F
J
J
J
J
J
J
J
J
J
J
J
J
J
J
J
J
J
J
J
J
J
J
J
J
J
J
J
J
F
"}
(3,1,1) = {"
F
J
J
J
J
J
U
U
U
U
U
U
J
J
J
J
J
J
J
J
U
U
U
U
U
U
J
J
J
F
"}
(4,1,1) = {"
F
J
J
J
U
U
U
U
U
U
U
U
U
U
U
U
U
U
U
U
U
U
U
U
U
U
J
J
J
F
"}
(5,1,1) = {"
F
J
J
U
a
a
a
a
a
a
a
a
a
a
a
a
a
U
U
U
U
U
U
U
U
U
U
U
J
F
"}
(6,1,1) = {"
F
J
U
U
a
Z
Z
Z
Z
Z
Z
Z
Z
Z
Z
V
a
U
U
U
U
U
U
U
U
U
U
U
U
F
"}
(7,1,1) = {"
F
J
U
U
a
Z
i
Z
Z
i
Z
Z
i
Z
Z
V
a
a
a
a
a
a
a
e
o
a
a
a
U
F
"}
(8,1,1) = {"
F
J
U
U
a
Z
i
Z
Z
i
Z
Z
i
Z
Z
V
V
V
V
Z
Z
V
a
Z
Z
Z
Z
a
U
F
"}
(9,1,1) = {"
F
J
U
U
a
Z
i
Z
Z
i
Z
Z
i
Z
Z
Z
Z
Z
V
Z
Z
V
a
Z
Z
Z
Z
a
U
F
"}
(10,1,1) = {"
F
J
U
U
a
Z
i
Z
Z
i
Z
Z
i
Z
Z
Z
Z
Z
V
Z
Z
Z
a
Z
Z
Z
Z
a
U
F
"}
(11,1,1) = {"
F
J
J
U
a
Z
i
Z
Z
i
Z
Z
i
Z
Z
Z
Z
Z
V
Z
Z
Z
a
Z
Z
Z
Z
a
U
F
"}
(12,1,1) = {"
F
J
J
U
a
Z
Z
Z
Z
Z
Z
Z
Z
Z
Z
Z
Z
Z
V
V
Z
Z
a
Z
Z
Z
Z
a
J
F
"}
(13,1,1) = {"
F
J
J
U
a
Z
Z
Z
Z
Z
Z
Z
Z
Z
Z
Z
Z
Z
Z
Z
Z
Z
a
a
a
e
o
a
J
F
"}
(14,1,1) = {"
F
J
J
U
a
Z
i
i
i
i
i
Z
i
i
i
i
i
Z
Z
Z
Z
Z
V
V
V
Z
Z
a
J
F
"}
(15,1,1) = {"
F
J
J
U
a
Z
Z
Z
Z
Z
Z
Z
Z
Z
Z
Z
Z
Z
Z
Z
Z
Z
Z
Z
Z
Z
Z
a
J
F
"}
(16,1,1) = {"
F
J
J
U
a
Z
Z
Z
Z
Z
Z
Z
Z
Z
Z
Z
Z
Z
Z
Z
Z
Z
Z
Z
Z
Z
Z
a
J
F
"}
(17,1,1) = {"
F
J
J
U
a
Z
i
i
i
i
i
Z
i
i
i
i
i
Z
Z
Z
Z
Z
V
V
V
Z
Z
a
J
F
"}
(18,1,1) = {"
F
J
J
J
a
Z
Z
Z
Z
Z
Z
Z
Z
Z
Z
Z
Z
Z
Z
i
Z
Z
Z
Z
Z
Z
Z
a
J
F
"}
(19,1,1) = {"
F
J
J
J
a
Z
Z
Z
Z
Z
Z
Z
Z
Z
Z
Z
Z
Z
Z
i
Z
Z
Z
Z
Z
Z
Z
a
J
F
"}
(20,1,1) = {"
F
J
J
U
a
Z
i
i
i
i
i
Z
i
i
i
i
i
Z
Z
i
Z
Z
V
V
V
Z
Z
a
J
F
"}
(21,1,1) = {"
F
J
J
U
a
Z
Z
Z
Z
Z
Z
Z
Z
Z
Z
Z
Z
Z
Z
i
Z
Z
Z
Z
Z
Z
Z
a
U
F
"}
(22,1,1) = {"
F
J
U
U
a
Z
Z
Z
Z
Z
Z
Z
Z
Z
Z
Z
Z
Z
Z
i
Z
Z
Z
Z
Z
Z
Z
a
U
F
"}
(23,1,1) = {"
F
J
U
U
a
Z
i
i
i
i
i
Z
i
i
i
i
i
Z
Z
i
Z
Z
V
V
V
Z
Z
a
U
F
"}
(24,1,1) = {"
F
J
U
U
a
Z
Z
Z
Z
Z
Z
Z
Z
Z
Z
Z
Z
Z
Z
i
Z
Z
Z
Z
Z
Z
Z
a
U
F
"}
(25,1,1) = {"
F
J
U
U
a
Z
Z
Z
Z
Z
Z
Z
Z
Z
Z
Z
Z
Z
Z
i
Z
Z
a
a
a
a
N
a
U
F
"}
(26,1,1) = {"
F
J
U
U
a
Z
i
i
i
i
i
Z
i
i
i
i
i
Z
Z
i
Z
Z
a
Z
Z
Z
Z
a
U
F
"}
(27,1,1) = {"
F
J
J
U
a
Z
Z
Z
Z
Z
Z
Z
Z
Z
Z
Z
Z
Z
Z
Z
Z
Z
a
Z
Z
Z
Z
a
U
F
"}
(28,1,1) = {"
F
J
J
J
a
a
a
a
a
a
a
a
a
a
a
a
a
a
a
a
a
a
a
a
a
a
a
a
J
F
"}
(29,1,1) = {"
F
J
J
J
U
U
U
U
U
U
U
U
U
U
U
U
U
J
J
U
U
U
U
U
U
U
U
J
J
F
"}
(30,1,1) = {"
F
F
F
F
F
F
F
F
F
F
F
F
F
F
F
F
F
F
F
F
F
F
F
F
F
F
F
F
F
F
"}
