//MAP CONVERTED BY dmm2tgm.py THIS HEADER COMMENT PREVENTS RECONVERSION, DO NOT REMOVE
"a" = (
/turf/template_noop,
/area/mine/unexplored/muriki/cave/deepdark)
"e" = (
/obj/random/trash,
/turf/simulated/floor/plating/turfpack/muriki,
/area/mine/explored/muriki/cave/deepdark)
"n" = (
/obj/machinery/door/airlock/maintenance/int,
/turf/simulated/floor/tiled/techfloor/turfpack/muriki,
/area/mine/explored/muriki/cave/deepdark)
"o" = (
/turf/simulated/mineral/floor/ignore_cavegen/turfpack/muriki,
/area/mine/explored/muriki/cave/deepdark)
"r" = (
/turf/template_noop,
/area/template_noop)
"C" = (
/obj/effect/landmark/step_trap,
/turf/simulated/floor/plating/turfpack/muriki,
/area/mine/explored/muriki/cave/deepdark)
"E" = (
/turf/simulated/wall,
/area/mine/explored/muriki/cave/deepdark)
"H" = (
/turf/simulated/floor/plating/turfpack/muriki,
/area/mine/explored/muriki/cave/deepdark)
"K" = (
/turf/template_noop,
/area/mine/explored/muriki/cave/deepdark)
"L" = (
/obj/structure/trash_pile,
/turf/simulated/mineral/floor/ignore_cavegen/turfpack/muriki,
/area/mine/explored/muriki/cave/deepdark)
"T" = (
/obj/machinery/trailblazer/yellow,
/turf/simulated/mineral/floor/ignore_cavegen/turfpack/muriki,
/area/mine/explored/muriki/cave/deepdark)

(1,1,1) = {"
r
r
r
r
r
r
r
r
r
r
r
r
r
r
r
r
r
r
r
r
r
r
r
r
r
"}
(2,1,1) = {"
r
a
a
a
T
H
K
a
a
a
a
a
a
a
a
a
a
a
a
a
a
a
a
a
r
"}
(3,1,1) = {"
r
a
a
a
o
H
E
a
a
a
a
a
a
a
a
a
a
a
a
a
a
a
a
a
r
"}
(4,1,1) = {"
r
a
a
a
E
H
E
a
a
a
a
a
a
a
a
a
a
a
a
a
a
a
a
a
r
"}
(5,1,1) = {"
r
a
a
a
E
n
E
a
a
a
a
a
a
a
a
a
a
a
a
a
a
a
a
a
r
"}
(6,1,1) = {"
r
a
a
E
H
H
E
E
E
K
E
E
E
E
E
E
K
K
E
E
E
E
E
K
r
"}
(7,1,1) = {"
r
a
a
E
H
E
e
H
H
H
C
H
e
H
H
H
e
H
H
n
H
C
K
K
r
"}
(8,1,1) = {"
r
a
a
E
H
H
H
E
E
K
E
E
o
L
E
E
E
E
E
E
E
K
K
a
r
"}
(9,1,1) = {"
r
a
a
a
E
n
E
a
a
a
a
a
a
T
a
a
a
a
a
a
a
a
a
a
r
"}
(10,1,1) = {"
r
a
a
a
K
H
E
a
a
a
a
a
a
a
a
a
a
a
a
a
a
a
a
a
r
"}
(11,1,1) = {"
r
a
a
a
K
H
E
a
a
a
a
a
a
a
a
a
a
a
a
a
a
a
a
a
r
"}
(12,1,1) = {"
r
a
a
a
E
H
K
a
a
a
a
a
a
a
a
a
a
a
a
a
a
a
a
a
r
"}
(13,1,1) = {"
r
a
a
a
a
H
E
a
a
a
a
a
a
a
a
a
a
a
a
a
a
a
a
a
r
"}
(14,1,1) = {"
r
a
a
a
E
H
K
a
a
a
a
a
a
a
a
a
a
a
a
a
a
a
a
a
r
"}
(15,1,1) = {"
r
a
a
a
K
C
E
a
a
a
a
a
a
a
a
a
a
a
a
a
a
a
a
a
r
"}
(16,1,1) = {"
r
a
a
a
E
H
E
a
a
a
a
a
a
a
a
a
a
a
a
a
a
a
a
a
r
"}
(17,1,1) = {"
r
a
a
a
E
e
E
a
a
a
a
a
a
a
a
a
a
a
a
a
a
a
a
a
r
"}
(18,1,1) = {"
r
a
a
a
E
H
E
a
a
a
a
a
a
a
a
a
a
a
a
a
a
a
a
a
r
"}
(19,1,1) = {"
r
a
a
T
o
e
E
a
a
a
a
a
a
a
a
a
a
a
a
a
a
a
a
a
r
"}
(20,1,1) = {"
r
a
a
a
L
H
E
a
a
a
a
a
a
a
a
a
a
a
a
a
a
a
a
a
r
"}
(21,1,1) = {"
r
a
a
a
E
n
E
a
a
a
a
a
a
a
a
a
a
a
a
a
a
a
a
a
r
"}
(22,1,1) = {"
r
a
a
a
E
H
E
a
a
a
a
a
a
a
a
a
a
a
a
a
a
a
a
a
r
"}
(23,1,1) = {"
r
a
a
a
E
H
E
a
a
a
a
a
a
a
a
a
a
a
a
a
a
a
a
a
r
"}
(24,1,1) = {"
r
a
a
a
E
a
a
a
a
a
a
a
a
a
a
a
a
a
a
a
a
a
a
a
r
"}
(25,1,1) = {"
r
r
r
r
r
r
r
r
r
r
r
r
r
r
r
r
r
r
r
r
r
r
r
r
r
"}
