//MAP CONVERTED BY dmm2tgm.py THIS HEADER COMMENT PREVENTS RECONVERSION, DO NOT REMOVE
"a" = (
/turf/template_noop,
/area/mine/unexplored/muriki/cave/deepdark)
"k" = (
/turf/simulated/floor/plating/turfpack/muriki,
/area/mine/explored/muriki/cave/deepdark)
"m" = (
/turf/simulated/wall,
/area/mine/explored/muriki/cave/deepdark)
"n" = (
/obj/effect/mine/claymore,
/turf/simulated/floor/plating/turfpack/muriki,
/area/mine/explored/muriki/cave/deepdark)
"p" = (
/obj/effect/mine/claymore{
	dir = 8
	},
/turf/simulated/floor/plating/turfpack/muriki,
/area/mine/explored/muriki/cave/deepdark)
"r" = (
/obj/structure/trash_pile,
/turf/simulated/mineral/floor/ignore_cavegen/turfpack/muriki,
/area/mine/explored/muriki/cave/deepdark)
"v" = (
/obj/structure/trash_pile,
/turf/simulated/floor/plating/turfpack/muriki,
/area/mine/explored/muriki/cave/deepdark)
"x" = (
/obj/random/maintenance,
/turf/simulated/floor/plating/turfpack/muriki,
/area/mine/explored/muriki/cave/deepdark)
"A" = (
/obj/machinery/trailblazer/yellow,
/turf/simulated/mineral/floor/ignore_cavegen/turfpack/muriki,
/area/mine/explored/muriki/cave/deepdark)
"G" = (
/turf/template_noop,
/area/mine/explored/muriki/cave/deepdark)
"L" = (
/obj/effect/landmark/step_trap,
/turf/simulated/floor/plating/turfpack/muriki,
/area/mine/explored/muriki/cave/deepdark)
"P" = (
/turf/simulated/mineral/floor/ignore_cavegen/turfpack/muriki,
/area/mine/explored/muriki/cave/deepdark)
"T" = (
/obj/random/trash,
/turf/simulated/floor/plating/turfpack/muriki,
/area/mine/explored/muriki/cave/deepdark)
"U" = (
/obj/machinery/door/airlock/maintenance/int,
/turf/simulated/floor/tiled/techfloor/turfpack/muriki,
/area/mine/explored/muriki/cave/deepdark)
"V" = (
/turf/template_noop,
/area/template_noop)
"Y" = (
/obj/structure/barricade,
/turf/simulated/floor/plating/turfpack/muriki,
/area/mine/explored/muriki/cave/deepdark)

(1,1,1) = {"
V
V
V
V
V
V
V
V
V
V
V
V
V
V
V
V
V
V
V
V
V
V
V
V
V
V
V
V
V
V
V
V
V
V
V
V
V
V
V
V
"}
(2,1,1) = {"
V
a
a
a
a
a
a
a
a
a
a
a
a
a
a
a
a
a
a
a
a
a
a
a
a
a
a
a
a
a
a
a
a
a
a
a
a
a
a
V
"}
(3,1,1) = {"
V
a
a
a
a
a
a
a
a
a
a
a
a
a
a
a
a
a
a
a
a
a
a
a
a
a
a
a
a
a
a
a
a
a
a
a
a
a
a
V
"}
(4,1,1) = {"
V
a
a
a
a
a
a
a
a
a
a
a
a
a
a
a
a
a
a
a
a
a
a
a
a
a
a
a
a
a
a
a
a
a
a
a
a
a
a
V
"}
(5,1,1) = {"
V
a
a
a
a
a
a
a
a
a
a
a
a
a
a
a
a
a
a
a
a
a
a
a
a
a
a
a
a
a
a
a
a
a
a
a
a
a
a
V
"}
(6,1,1) = {"
V
a
a
a
a
a
a
a
a
a
a
a
a
a
a
a
a
a
a
a
a
a
a
a
a
a
a
a
a
a
a
a
a
a
a
a
a
a
a
V
"}
(7,1,1) = {"
V
a
a
a
a
a
a
a
A
k
G
a
a
a
a
a
a
a
a
a
a
a
a
a
a
a
a
a
a
a
a
a
a
a
a
a
a
a
a
V
"}
(8,1,1) = {"
V
a
a
a
a
a
a
a
P
k
m
a
a
a
a
a
a
a
a
a
a
a
a
a
a
a
a
a
a
a
a
a
a
a
a
a
a
a
a
V
"}
(9,1,1) = {"
V
a
a
a
a
a
a
a
m
k
m
a
a
a
a
a
a
a
a
a
a
a
a
a
a
a
a
a
a
a
a
a
a
a
a
a
a
a
a
V
"}
(10,1,1) = {"
V
a
a
a
a
a
a
a
m
k
m
a
a
a
a
a
a
a
a
a
a
a
a
a
a
a
a
a
a
a
a
a
a
a
a
a
a
a
a
V
"}
(11,1,1) = {"
V
a
a
a
a
a
a
a
T
k
m
a
a
a
a
a
a
a
a
a
a
a
a
a
a
a
a
a
a
a
a
a
a
a
a
a
a
a
a
V
"}
(12,1,1) = {"
V
a
a
a
a
a
a
a
m
U
m
a
a
a
a
a
a
a
a
a
a
a
a
a
a
a
a
a
a
a
a
a
a
a
a
a
a
a
a
V
"}
(13,1,1) = {"
V
a
a
a
a
a
a
m
k
k
m
m
m
G
m
m
m
m
m
m
G
G
G
G
m
m
m
G
G
m
m
m
m
m
G
a
a
a
a
V
"}
(14,1,1) = {"
V
a
a
a
a
a
a
m
k
m
T
k
k
k
L
Y
T
k
k
k
T
k
k
T
k
k
k
T
k
k
U
k
L
G
G
a
a
a
a
V
"}
(15,1,1) = {"
V
a
a
a
a
a
a
m
k
k
k
m
m
G
m
m
P
r
m
m
m
m
m
m
Y
Y
m
m
m
m
m
m
G
G
a
a
a
a
a
V
"}
(16,1,1) = {"
V
a
a
a
a
a
a
a
m
U
m
a
a
a
a
a
a
A
a
a
a
m
n
x
k
k
L
m
a
a
a
a
a
a
a
a
a
a
a
V
"}
(17,1,1) = {"
V
a
a
a
a
a
a
a
m
k
G
a
a
a
a
a
a
a
a
a
a
m
k
k
k
k
x
m
a
a
a
a
a
a
a
a
a
a
a
V
"}
(18,1,1) = {"
V
a
a
a
a
a
a
a
a
k
m
a
a
a
a
a
a
a
a
a
a
m
m
v
v
x
k
m
a
a
a
a
a
a
a
a
a
a
a
V
"}
(19,1,1) = {"
V
a
a
a
a
a
a
a
m
k
G
a
a
a
a
a
a
a
a
a
a
a
m
m
m
m
m
m
a
a
a
a
a
a
a
a
a
a
a
V
"}
(20,1,1) = {"
V
a
a
a
a
a
a
a
G
L
m
a
a
a
a
a
a
a
a
a
a
a
a
a
a
a
a
a
a
a
a
a
a
a
a
a
a
a
a
V
"}
(21,1,1) = {"
V
a
a
a
a
a
a
a
m
k
m
a
a
a
a
a
a
a
a
a
a
a
a
a
a
a
a
a
a
a
a
a
a
a
a
a
a
a
a
V
"}
(22,1,1) = {"
V
a
a
a
a
a
a
a
m
T
m
a
a
a
a
a
a
a
a
a
a
a
a
a
a
a
a
a
a
a
a
a
a
a
a
a
a
a
a
V
"}
(23,1,1) = {"
V
a
a
a
a
a
a
a
m
p
m
a
a
a
a
a
a
a
a
a
a
a
a
a
a
a
a
a
a
a
a
a
a
a
a
a
a
a
a
V
"}
(24,1,1) = {"
V
a
a
a
a
a
a
a
P
T
m
a
a
a
a
a
a
a
a
a
a
a
a
a
a
a
a
a
a
a
a
a
a
a
a
a
a
a
a
V
"}
(25,1,1) = {"
V
a
a
a
a
a
a
a
r
k
m
a
a
a
a
a
a
a
a
a
a
a
a
a
a
a
a
a
a
a
a
a
a
a
a
a
a
a
a
V
"}
(26,1,1) = {"
V
a
a
a
a
a
a
a
m
U
m
a
a
a
a
a
a
a
a
a
a
a
a
a
a
G
k
a
a
a
a
a
a
a
a
a
a
a
a
V
"}
(27,1,1) = {"
V
a
a
a
a
a
a
a
m
k
m
m
m
m
a
a
a
a
a
a
a
a
a
a
a
m
k
a
a
a
a
a
a
a
a
a
a
a
a
V
"}
(28,1,1) = {"
V
a
a
a
a
a
a
a
m
Y
m
k
v
m
a
a
a
a
a
a
a
a
a
a
a
m
L
m
a
a
a
a
a
a
a
a
a
a
a
V
"}
(29,1,1) = {"
V
a
a
a
a
a
a
a
P
k
U
k
k
m
a
a
a
a
a
a
a
a
a
a
a
m
U
m
a
a
a
a
a
a
a
a
a
a
a
V
"}
(30,1,1) = {"
V
a
a
a
a
a
a
a
m
k
m
k
k
m
m
m
G
G
G
G
m
m
m
G
m
k
p
k
m
a
a
a
a
a
a
a
a
a
a
V
"}
(31,1,1) = {"
V
a
a
a
a
a
a
a
m
k
m
k
k
U
Y
k
T
k
k
T
k
L
k
T
Y
k
m
T
m
a
a
a
a
a
a
a
a
a
a
V
"}
(32,1,1) = {"
V
a
a
a
a
a
a
a
k
k
m
m
m
m
m
m
m
m
m
m
k
v
m
m
m
m
k
k
m
a
a
a
a
a
a
a
a
a
a
V
"}
(33,1,1) = {"
V
a
a
a
a
a
a
a
A
k
m
a
a
a
a
a
a
a
a
a
a
a
a
a
a
m
U
m
a
a
a
a
a
a
a
a
a
a
a
V
"}
(34,1,1) = {"
V
a
a
a
a
a
a
a
a
G
G
a
a
a
a
a
a
a
a
a
a
a
a
a
a
m
k
r
a
a
a
a
a
a
a
a
a
a
a
V
"}
(35,1,1) = {"
V
a
a
a
a
a
a
a
a
a
a
a
a
a
a
a
a
a
a
a
a
a
a
a
a
a
k
A
a
a
a
a
a
a
a
a
a
a
a
V
"}
(36,1,1) = {"
V
a
a
a
a
a
a
a
a
a
a
a
a
a
a
a
a
a
a
a
a
a
a
a
a
a
a
a
a
a
a
a
a
a
a
a
a
a
a
V
"}
(37,1,1) = {"
V
a
a
a
a
a
a
a
a
a
a
a
a
a
a
a
a
a
a
a
a
a
a
a
a
a
a
a
a
a
a
a
a
a
a
a
a
a
a
V
"}
(38,1,1) = {"
V
a
a
a
a
a
a
a
a
a
a
a
a
a
a
a
a
a
a
a
a
a
a
a
a
a
a
a
a
a
a
a
a
a
a
a
a
a
a
V
"}
(39,1,1) = {"
V
a
a
a
a
a
a
a
a
a
a
a
a
a
a
a
a
a
a
a
a
a
a
a
a
a
a
a
a
a
a
a
a
a
a
a
a
a
a
V
"}
(40,1,1) = {"
V
V
V
V
V
V
V
V
V
V
V
V
V
V
V
V
V
V
V
V
V
V
V
V
V
V
V
V
V
V
V
V
V
V
V
V
V
V
V
V
"}
