//MAP CONVERTED BY dmm2tgm.py THIS HEADER COMMENT PREVENTS RECONVERSION, DO NOT REMOVE
"a" = (
/turf/template_noop,
/area/mine/unexplored/muriki/cave/deepdark)
"j" = (
/obj/structure/trash_pile,
/turf/simulated/mineral/floor/ignore_cavegen/turfpack/muriki,
/area/mine/explored/muriki/cave/deepdark)
"m" = (
/turf/template_noop,
/area/mine/explored/muriki/cave/deepdark)
"n" = (
/turf/simulated/wall,
/area/mine/explored/muriki/cave/deepdark)
"o" = (
/obj/machinery/door/airlock/maintenance/int,
/turf/simulated/floor/tiled/techfloor/turfpack/muriki,
/area/mine/explored/muriki/cave/deepdark)
"s" = (
/turf/simulated/mineral/floor/ignore_cavegen/turfpack/muriki,
/area/mine/explored/muriki/cave/deepdark)
"x" = (
/obj/random/trash,
/turf/simulated/floor/plating/turfpack/muriki,
/area/mine/explored/muriki/cave/deepdark)
"D" = (
/obj/effect/landmark/step_trap,
/turf/simulated/floor/plating/turfpack/muriki,
/area/mine/explored/muriki/cave/deepdark)
"G" = (
/turf/simulated/floor/plating/turfpack/muriki,
/area/mine/explored/muriki/cave/deepdark)
"H" = (
/turf/template_noop,
/area/template_noop)
"J" = (
/obj/machinery/trailblazer/yellow,
/turf/simulated/mineral/floor/ignore_cavegen/turfpack/muriki,
/area/mine/explored/muriki/cave/deepdark)
"V" = (
/obj/structure/trash_pile,
/turf/simulated/floor/plating/turfpack/muriki,
/area/mine/explored/muriki/cave/deepdark)

(1,1,1) = {"
H
H
H
H
H
H
H
H
H
H
H
H
"}
(2,1,1) = {"
H
a
a
a
a
a
G
n
a
a
a
H
"}
(3,1,1) = {"
H
a
a
a
a
n
G
m
a
a
a
H
"}
(4,1,1) = {"
H
a
a
a
a
m
G
n
a
a
a
H
"}
(5,1,1) = {"
H
a
a
a
a
n
x
n
a
a
a
H
"}
(6,1,1) = {"
H
a
a
a
a
n
G
n
a
a
a
H
"}
(7,1,1) = {"
H
a
a
a
a
n
G
n
a
a
a
H
"}
(8,1,1) = {"
H
a
a
a
a
s
G
n
a
a
a
H
"}
(9,1,1) = {"
H
a
a
a
a
J
x
m
a
a
a
H
"}
(10,1,1) = {"
H
a
a
a
a
j
D
n
a
a
a
H
"}
(11,1,1) = {"
H
a
a
a
a
n
G
n
a
a
a
H
"}
(12,1,1) = {"
H
a
a
a
a
n
o
n
a
a
a
H
"}
(13,1,1) = {"
H
a
a
a
n
G
G
n
n
a
a
H
"}
(14,1,1) = {"
H
a
a
a
G
G
n
V
n
a
a
H
"}
(15,1,1) = {"
H
a
a
a
n
x
G
G
n
a
a
H
"}
(16,1,1) = {"
H
a
a
a
a
n
o
n
a
a
a
H
"}
(17,1,1) = {"
H
a
a
a
a
m
D
n
a
a
a
H
"}
(18,1,1) = {"
H
a
a
a
a
m
G
n
a
a
a
H
"}
(19,1,1) = {"
H
a
a
a
J
s
G
n
a
a
a
H
"}
(20,1,1) = {"
H
a
a
a
a
n
x
n
a
a
a
H
"}
(21,1,1) = {"
H
a
a
a
a
n
G
n
a
a
a
H
"}
(22,1,1) = {"
H
a
a
a
a
n
G
n
a
a
a
H
"}
(23,1,1) = {"
H
a
a
a
a
n
G
n
a
a
a
H
"}
(24,1,1) = {"
H
a
a
a
a
n
G
n
a
a
a
H
"}
(25,1,1) = {"
H
a
a
a
a
s
x
V
a
a
a
H
"}
(26,1,1) = {"
H
a
a
a
a
J
G
m
a
a
a
H
"}
(27,1,1) = {"
H
a
a
a
a
s
G
n
a
a
a
H
"}
(28,1,1) = {"
H
a
a
a
a
n
G
n
a
a
a
H
"}
(29,1,1) = {"
H
a
a
a
a
n
G
n
a
a
a
H
"}
(30,1,1) = {"
H
a
a
a
a
n
x
n
a
a
a
H
"}
(31,1,1) = {"
H
a
a
a
a
n
o
n
a
a
a
H
"}
(32,1,1) = {"
H
a
a
a
n
D
G
x
n
a
a
H
"}
(33,1,1) = {"
H
a
a
a
n
V
n
x
n
a
a
H
"}
(34,1,1) = {"
H
a
a
a
n
n
G
G
n
a
a
H
"}
(35,1,1) = {"
H
a
a
a
a
s
G
n
a
a
a
H
"}
(36,1,1) = {"
H
a
a
a
a
J
G
m
a
a
a
H
"}
(37,1,1) = {"
H
a
a
a
a
s
G
n
a
a
a
H
"}
(38,1,1) = {"
H
a
a
a
a
n
G
n
a
a
a
H
"}
(39,1,1) = {"
H
a
a
a
a
a
a
a
a
a
a
H
"}
(40,1,1) = {"
H
H
H
H
H
H
H
H
H
H
H
H
"}
