//MAP CONVERTED BY dmm2tgm.py THIS HEADER COMMENT PREVENTS RECONVERSION, DO NOT REMOVE
"a" = (
/turf/simulated/wall,
/area/mine/explored/muriki/cave/deepdark)
"b" = (
/turf/simulated/wall,
/area/mine/unexplored/muriki/cave/deepdark)
"j" = (
/turf/template_noop,
/area/mine/explored/muriki/cave/deepdark)
"n" = (
/obj/machinery/trailblazer/yellow,
/turf/simulated/mineral/floor/ignore_cavegen/turfpack/muriki,
/area/mine/unexplored/muriki/cave/deepdark)
"p" = (
/obj/machinery/trailblazer/yellow,
/turf/simulated/mineral/floor/ignore_cavegen/turfpack/muriki,
/area/mine/explored/muriki/cave/deepdark)
"q" = (
/obj/effect/mine/claymore{
	dir = 1
	},
/turf/simulated/floor/plating/turfpack/muriki,
/area/mine/explored/muriki/cave/deepdark)
"s" = (
/obj/random/maintenance,
/turf/simulated/floor/plating/turfpack/muriki,
/area/mine/explored/muriki/cave/deepdark)
"t" = (
/obj/machinery/door/airlock/maintenance/int,
/turf/simulated/floor/tiled/techfloor/turfpack/muriki,
/area/mine/explored/muriki/cave/deepdark)
"x" = (
/obj/random/plushielarge,
/turf/simulated/floor/plating/turfpack/muriki,
/area/mine/explored/muriki/cave/deepdark)
"z" = (
/obj/random/flashlight,
/turf/simulated/floor/plating/turfpack/muriki,
/area/mine/explored/muriki/cave/deepdark)
"A" = (
/turf/template_noop,
/area/template_noop)
"B" = (
/obj/random/mainttoyloot/nofail,
/turf/simulated/mineral/floor/ignore_cavegen/turfpack/muriki,
/area/mine/explored/muriki/cave/deepdark)
"C" = (
/obj/random/trash,
/obj/structure/barricade,
/turf/simulated/floor/plating/turfpack/muriki,
/area/mine/explored/muriki/cave/deepdark)
"D" = (
/obj/structure/barricade,
/turf/simulated/floor/plating/turfpack/muriki,
/area/mine/explored/muriki/cave/deepdark)
"E" = (
/obj/random/cutout,
/turf/simulated/floor/plating/turfpack/muriki,
/area/mine/explored/muriki/cave/deepdark)
"F" = (
/obj/random/firstaid,
/turf/simulated/floor/plating/turfpack/muriki,
/area/mine/explored/muriki/cave/deepdark)
"G" = (
/obj/random/trash,
/obj/random/cutout,
/turf/simulated/floor/plating/turfpack/muriki,
/area/mine/explored/muriki/cave/deepdark)
"H" = (
/obj/structure/trash_pile,
/turf/simulated/mineral/floor/ignore_cavegen/turfpack/muriki,
/area/mine/explored/muriki/cave/deepdark)
"I" = (
/obj/random/contraband/nofail,
/turf/simulated/mineral/floor/ignore_cavegen/turfpack/muriki,
/area/mine/explored/muriki/cave/deepdark)
"J" = (
/obj/random/maintenance,
/turf/simulated/mineral/floor/ignore_cavegen/turfpack/muriki,
/area/mine/explored/muriki/cave/deepdark)
"L" = (
/turf/simulated/floor/plating/turfpack/muriki,
/area/mine/explored/muriki/cave/deepdark)
"M" = (
/turf/template_noop,
/area/mine/unexplored/muriki/cave/deepdark)
"N" = (
/obj/structure/trash_pile,
/turf/simulated/floor/plating/turfpack/muriki,
/area/mine/explored/muriki/cave/deepdark)
"O" = (
/turf/simulated/mineral/alt/turfpack/muriki,
/area/mine/unexplored/muriki/cave/deepdark)
"P" = (
/obj/random/trash,
/turf/simulated/floor/plating/turfpack/muriki,
/area/mine/explored/muriki/cave/deepdark)
"Q" = (
/obj/effect/landmark/step_trap,
/turf/simulated/floor/plating/turfpack/muriki,
/area/mine/explored/muriki/cave/deepdark)
"S" = (
/turf/simulated/floor/plating/turfpack/muriki,
/area/mine/unexplored/muriki/cave/deepdark)
"T" = (
/turf/simulated/mineral/floor/ignore_cavegen/turfpack/muriki,
/area/mine/unexplored/muriki/cave/deepdark)
"W" = (
/obj/effect/mine/claymore{
	dir = 4
	},
/turf/simulated/floor/plating/turfpack/muriki,
/area/mine/explored/muriki/cave/deepdark)
"Y" = (
/turf/simulated/mineral/alt/turfpack/muriki,
/area/mine/explored/muriki/cave/deepdark)
"Z" = (
/turf/simulated/mineral/floor/ignore_cavegen/turfpack/muriki,
/area/mine/explored/muriki/cave/deepdark)

(1,1,1) = {"
A
A
A
A
A
A
A
A
A
A
A
A
A
A
A
A
A
A
A
A
"}
(2,1,1) = {"
A
M
M
M
M
M
M
M
M
M
M
M
M
M
M
M
M
M
M
A
"}
(3,1,1) = {"
A
M
M
M
M
M
M
M
M
M
M
M
M
M
M
M
M
M
M
A
"}
(4,1,1) = {"
A
M
M
j
L
j
M
M
M
M
M
M
M
M
M
M
M
M
M
A
"}
(5,1,1) = {"
A
M
M
a
Z
j
M
M
M
M
M
M
M
M
M
M
M
M
M
A
"}
(6,1,1) = {"
A
M
M
a
L
Z
M
M
M
M
M
M
M
M
M
M
M
M
M
A
"}
(7,1,1) = {"
A
M
M
a
s
Z
M
M
M
M
M
M
M
M
M
M
M
M
M
A
"}
(8,1,1) = {"
A
M
M
p
L
a
T
M
M
M
M
M
M
M
M
M
M
M
M
A
"}
(9,1,1) = {"
A
M
M
Z
Z
a
T
M
M
M
M
M
M
M
M
M
M
M
M
A
"}
(10,1,1) = {"
A
M
M
j
P
a
H
j
j
j
M
M
O
O
M
M
M
M
M
A
"}
(11,1,1) = {"
A
M
M
a
s
Z
Z
j
j
j
M
O
O
O
O
M
M
M
M
A
"}
(12,1,1) = {"
A
M
M
a
L
a
a
a
a
a
a
a
a
Y
Y
Y
O
M
M
A
"}
(13,1,1) = {"
A
M
M
a
Z
t
L
C
t
L
L
q
a
I
Y
Y
O
M
M
A
"}
(14,1,1) = {"
A
M
M
a
Q
a
a
a
a
L
L
N
a
Z
p
Y
O
M
M
A
"}
(15,1,1) = {"
A
M
M
a
t
a
N
z
E
P
L
P
a
B
I
Y
O
M
M
A
"}
(16,1,1) = {"
A
M
M
a
L
a
s
L
L
L
F
N
a
Y
Y
Y
O
M
M
A
"}
(17,1,1) = {"
A
M
M
a
L
a
L
P
L
L
a
a
a
Y
Y
Y
M
M
M
A
"}
(18,1,1) = {"
A
M
M
a
P
a
a
a
t
a
a
Y
j
j
j
j
M
M
M
A
"}
(19,1,1) = {"
A
M
M
a
P
a
L
a
L
H
Y
Y
j
a
a
a
a
a
M
A
"}
(20,1,1) = {"
A
M
M
p
L
a
L
a
Q
a
a
a
j
a
a
L
P
a
b
A
"}
(21,1,1) = {"
A
M
M
Z
L
a
L
a
C
a
L
L
L
t
L
a
L
t
S
A
"}
(22,1,1) = {"
A
M
M
a
L
a
a
a
L
t
L
P
a
a
s
Q
L
a
M
A
"}
(23,1,1) = {"
A
M
M
a
L
a
s
a
a
a
L
L
Z
a
a
t
a
a
M
A
"}
(24,1,1) = {"
A
M
M
a
L
a
L
s
L
a
L
L
Z
j
a
L
a
M
M
A
"}
(25,1,1) = {"
A
M
M
a
L
a
E
L
L
t
L
a
a
j
a
D
a
M
M
A
"}
(26,1,1) = {"
A
M
a
a
t
a
N
x
s
a
D
a
j
j
j
P
a
M
M
A
"}
(27,1,1) = {"
A
M
a
L
L
a
a
a
a
a
L
a
j
j
a
L
a
M
M
A
"}
(28,1,1) = {"
A
M
a
L
a
L
t
L
Q
L
q
a
j
j
a
L
a
M
M
A
"}
(29,1,1) = {"
A
M
a
L
L
L
a
a
a
Z
Z
a
j
M
J
L
H
M
M
A
"}
(30,1,1) = {"
A
M
a
a
t
a
a
j
H
p
j
j
M
M
a
L
Z
n
M
A
"}
(31,1,1) = {"
A
M
j
a
L
a
j
j
j
j
j
j
M
M
a
L
j
M
M
A
"}
(32,1,1) = {"
A
M
M
a
L
a
M
M
M
M
M
M
M
M
a
G
a
M
M
A
"}
(33,1,1) = {"
A
M
M
a
L
a
M
M
M
M
M
M
M
M
a
W
a
M
M
A
"}
(34,1,1) = {"
A
M
M
p
L
Z
M
M
M
M
M
M
M
M
a
L
a
M
M
A
"}
(35,1,1) = {"
A
M
M
j
Q
Z
M
M
M
M
M
M
M
M
a
L
Z
M
M
A
"}
(36,1,1) = {"
A
M
M
a
L
j
M
M
M
M
M
M
M
M
a
L
Z
M
M
A
"}
(37,1,1) = {"
A
M
M
a
D
a
M
M
M
M
M
M
M
M
a
t
a
M
M
A
"}
(38,1,1) = {"
A
M
M
a
Z
a
M
M
M
M
M
M
M
M
a
L
a
M
M
A
"}
(39,1,1) = {"
A
M
M
j
Z
j
M
M
M
M
M
M
M
M
Z
L
j
M
M
A
"}
(40,1,1) = {"
A
M
M
j
Z
Z
M
M
M
M
M
M
M
T
Z
Q
j
M
M
A
"}
(41,1,1) = {"
A
M
M
j
Z
a
M
M
M
M
M
M
M
M
a
L
j
M
M
A
"}
(42,1,1) = {"
A
M
M
j
t
a
M
M
M
M
M
M
M
M
a
L
a
M
M
A
"}
(43,1,1) = {"
A
M
M
j
Z
a
M
M
M
M
M
M
M
M
j
L
a
M
M
A
"}
(44,1,1) = {"
A
M
M
M
T
M
M
M
M
M
M
M
M
M
a
L
Z
M
M
A
"}
(45,1,1) = {"
A
M
M
M
M
M
M
M
M
M
M
M
M
M
j
L
Z
M
M
A
"}
(46,1,1) = {"
A
M
M
M
M
M
M
M
M
M
M
M
M
M
a
L
a
M
M
A
"}
(47,1,1) = {"
A
M
M
M
M
M
M
M
M
M
M
M
M
M
b
T
T
M
M
A
"}
(48,1,1) = {"
A
M
M
M
M
M
M
M
M
M
M
M
M
M
M
T
M
M
M
A
"}
(49,1,1) = {"
A
M
M
M
M
M
M
M
M
M
M
M
M
M
M
M
M
M
M
A
"}
(50,1,1) = {"
A
A
A
A
A
A
A
A
A
A
A
A
A
A
A
A
A
A
A
A
"}
