//MAP CONVERTED BY dmm2tgm.py THIS HEADER COMMENT PREVENTS RECONVERSION, DO NOT REMOVE
"a" = (
/turf/template_noop,
/area/template_noop)
"h" = (
/turf/template_noop,
/area/mine/unexplored/muriki/cave/deepdark)
"i" = (
/turf/simulated/mineral/floor/ignore_cavegen/turfpack/muriki,
/area/mine/explored/muriki/cave/deepdark)
"l" = (
/turf/simulated/mineral/floor/ignore_cavegen/turfpack/muriki,
/area/mine/unexplored/muriki/cave/deepdark)
"n" = (
/obj/structure/barricade,
/turf/simulated/floor/plating/turfpack/muriki,
/area/mine/explored/muriki/cave/deepdark)
"q" = (
/obj/structure/trash_pile,
/turf/simulated/mineral/floor/ignore_cavegen/turfpack/muriki,
/area/mine/unexplored/muriki/cave/deepdark)
"r" = (
/obj/random/contraband/nofail,
/turf/simulated/floor/plating/turfpack/muriki,
/area/mine/explored/muriki/cave/deepdark)
"s" = (
/turf/simulated/floor/plating/turfpack/muriki,
/area/mine/explored/muriki/cave/deepdark)
"t" = (
/obj/machinery/door/airlock/maintenance/int,
/turf/simulated/floor/tiled/techfloor/turfpack/muriki,
/area/mine/explored/muriki/cave/deepdark)
"G" = (
/obj/random/trash,
/turf/simulated/floor/plating/turfpack/muriki,
/area/mine/explored/muriki/cave/deepdark)
"H" = (
/obj/machinery/door/airlock/maintenance/int,
/obj/effect/landmark/step_trap,
/turf/simulated/floor/tiled/techfloor/turfpack/muriki,
/area/mine/explored/muriki/cave/deepdark)
"I" = (
/obj/structure/trash_pile,
/turf/simulated/mineral/floor/ignore_cavegen/turfpack/muriki,
/area/mine/explored/muriki/cave/deepdark)
"J" = (
/obj/effect/mine/claymore{
	dir = 8
	},
/turf/simulated/floor/plating/turfpack/muriki,
/area/mine/explored/muriki/cave/deepdark)
"M" = (
/turf/template_noop,
/area/mine/explored/muriki/cave/deepdark)
"R" = (
/obj/structure/trash_pile,
/turf/simulated/floor/plating/turfpack/muriki,
/area/mine/explored/muriki/cave/deepdark)
"U" = (
/obj/random/maintenance,
/turf/simulated/floor/plating/turfpack/muriki,
/area/mine/explored/muriki/cave/deepdark)
"W" = (
/obj/effect/landmark/step_trap,
/turf/simulated/floor/plating/turfpack/muriki,
/area/mine/explored/muriki/cave/deepdark)
"Y" = (
/obj/machinery/trailblazer/yellow,
/turf/simulated/mineral/floor/ignore_cavegen/turfpack/muriki,
/area/mine/explored/muriki/cave/deepdark)
"Z" = (
/turf/simulated/wall,
/area/mine/explored/muriki/cave/deepdark)

(1,1,1) = {"
a
a
a
a
a
a
a
a
a
a
a
a
a
a
a
a
a
a
a
a
a
a
a
a
a
a
a
a
a
a
a
a
a
a
a
"}
(2,1,1) = {"
a
h
h
h
h
h
h
h
h
h
h
h
h
h
h
h
h
h
h
h
h
h
h
h
h
h
h
h
h
h
h
h
h
h
a
"}
(3,1,1) = {"
a
h
h
h
h
h
h
h
h
h
h
h
h
h
h
h
h
h
h
h
h
h
h
h
h
h
h
h
h
h
h
h
h
h
a
"}
(4,1,1) = {"
a
h
h
h
h
h
h
h
h
h
h
h
h
h
h
M
M
M
h
h
h
h
h
h
h
h
h
h
h
h
h
h
h
h
a
"}
(5,1,1) = {"
a
h
h
h
h
h
h
h
h
h
h
h
h
h
h
Z
i
M
h
h
h
h
h
h
h
h
h
h
h
h
h
h
h
h
a
"}
(6,1,1) = {"
a
h
h
h
h
h
h
h
h
h
h
h
h
h
h
Z
s
i
h
h
h
h
h
h
h
h
h
h
h
h
h
h
h
h
a
"}
(7,1,1) = {"
a
h
h
h
h
h
h
h
h
h
h
h
h
h
h
Z
s
i
h
h
h
h
h
h
h
h
h
h
h
h
h
h
h
h
a
"}
(8,1,1) = {"
a
h
h
h
h
h
h
h
h
h
h
h
h
h
h
Y
s
Z
l
h
h
h
h
h
h
h
h
h
h
h
h
h
h
h
a
"}
(9,1,1) = {"
a
h
h
h
h
h
h
h
h
h
h
h
h
h
h
i
i
Z
l
h
h
h
h
h
h
h
h
h
h
h
h
h
h
h
a
"}
(10,1,1) = {"
a
h
h
h
h
h
h
h
h
h
h
h
h
h
h
M
G
Z
q
h
h
h
h
h
h
h
h
h
h
h
h
h
h
h
a
"}
(11,1,1) = {"
a
h
h
h
h
h
h
h
h
h
h
h
h
h
h
Z
U
i
l
h
h
h
h
h
h
h
h
h
h
h
h
h
h
h
a
"}
(12,1,1) = {"
a
h
h
h
h
h
h
h
h
h
h
h
h
h
h
Z
n
Z
l
h
h
h
h
h
h
h
h
h
h
h
h
h
h
h
a
"}
(13,1,1) = {"
a
h
h
h
h
h
h
h
h
h
h
h
h
h
h
Z
i
Z
l
h
h
h
h
h
h
h
h
h
h
h
h
h
h
h
a
"}
(14,1,1) = {"
a
h
h
h
h
h
h
h
h
h
h
h
h
h
h
Z
W
Z
l
h
h
h
h
h
h
h
h
h
h
h
h
h
h
h
a
"}
(15,1,1) = {"
a
h
h
h
h
h
h
h
h
h
h
h
h
h
h
Z
t
Z
l
h
h
h
h
h
h
h
h
h
h
h
h
h
h
h
a
"}
(16,1,1) = {"
a
h
h
h
h
h
h
h
h
h
h
h
h
h
h
Z
s
Z
l
h
h
h
h
h
h
h
h
h
h
h
h
h
h
h
a
"}
(17,1,1) = {"
a
h
h
h
h
h
h
h
h
h
h
h
h
h
h
Z
s
i
l
h
h
h
h
h
h
h
h
h
h
h
h
h
h
h
a
"}
(18,1,1) = {"
a
h
h
h
h
h
h
h
h
h
h
h
h
h
h
Z
G
Z
h
h
h
h
h
h
h
h
h
h
h
h
h
h
h
h
a
"}
(19,1,1) = {"
a
h
h
h
h
h
h
h
h
h
h
h
h
h
h
Z
G
Z
h
h
h
h
h
h
h
h
h
h
h
h
h
h
h
h
a
"}
(20,1,1) = {"
a
h
h
h
h
h
h
h
h
h
h
h
h
h
h
Z
s
i
h
h
h
h
h
h
h
h
h
h
h
h
h
h
h
h
a
"}
(21,1,1) = {"
a
h
h
h
h
h
h
h
h
h
h
h
h
h
h
i
i
Z
h
h
h
h
h
h
h
h
h
h
h
h
h
h
h
h
a
"}
(22,1,1) = {"
a
h
h
h
h
h
h
h
h
h
h
h
h
h
h
Z
s
Z
h
h
h
h
h
h
h
h
h
h
h
h
h
h
h
h
a
"}
(23,1,1) = {"
a
h
h
h
h
h
h
h
h
h
h
h
h
h
h
Z
s
Z
h
h
h
h
h
h
h
h
h
h
h
h
h
h
h
h
a
"}
(24,1,1) = {"
a
h
h
h
h
h
h
h
h
h
h
h
h
M
i
Z
s
Z
i
l
h
h
h
h
h
h
h
h
h
h
h
h
h
h
a
"}
(25,1,1) = {"
a
h
h
h
h
h
h
h
h
i
Y
i
i
i
Z
Z
t
Z
Z
i
i
i
i
i
i
l
h
h
h
h
h
h
h
h
a
"}
(26,1,1) = {"
a
h
h
Z
i
Z
Z
Z
Z
Z
Z
i
I
Z
Z
s
G
Z
Z
Z
Z
i
i
I
Z
Z
Z
Z
i
i
Z
Z
M
h
a
"}
(27,1,1) = {"
a
h
h
i
s
H
n
s
n
G
i
i
s
s
t
s
Z
W
t
s
n
s
G
s
s
s
s
G
i
s
t
i
M
h
a
"}
(28,1,1) = {"
a
h
h
M
Z
Z
Z
i
Z
Z
Z
Z
i
Z
Z
s
s
U
Z
Z
Z
t
Z
Z
Z
i
Y
Z
Z
Z
Z
Z
Z
h
a
"}
(29,1,1) = {"
a
h
h
h
h
h
h
h
h
h
h
h
h
M
Z
Z
Z
Z
Z
s
s
s
U
R
Z
M
h
h
h
h
h
h
h
h
a
"}
(30,1,1) = {"
a
h
h
h
h
h
h
h
h
h
h
h
h
h
h
h
M
M
Z
s
s
s
r
s
Z
M
h
h
h
h
h
h
h
h
a
"}
(31,1,1) = {"
a
h
h
h
h
h
h
h
h
h
h
h
h
h
h
h
M
M
Z
U
s
J
s
s
Z
M
h
h
h
h
h
h
h
h
a
"}
(32,1,1) = {"
a
h
h
h
h
h
h
h
h
h
h
h
h
h
h
h
M
M
Z
Z
Z
Z
R
R
Z
M
h
h
h
h
h
h
h
h
a
"}
(33,1,1) = {"
a
h
h
h
h
h
h
h
h
h
h
h
h
h
h
h
h
h
M
M
M
Z
Z
Z
Z
h
h
h
h
h
h
h
h
h
a
"}
(34,1,1) = {"
a
h
h
h
h
h
h
h
h
h
h
h
h
h
h
h
h
h
h
h
h
h
h
h
h
h
h
h
h
h
h
h
h
h
a
"}
(35,1,1) = {"
a
a
a
a
a
a
a
a
a
a
a
a
a
a
a
a
a
a
a
a
a
a
a
a
a
a
a
a
a
a
a
a
a
a
a
"}
