//MAP CONVERTED BY dmm2tgm.py THIS HEADER COMMENT PREVENTS RECONVERSION, DO NOT REMOVE
"a" = (
/turf/template_noop,
/area/mine/unexplored/muriki/cave/deepdark)
"n" = (
/obj/machinery/door/airlock/maintenance/int,
/turf/simulated/floor/tiled/techfloor/turfpack/muriki,
/area/mine/explored/muriki/cave/deepdark)
"o" = (
/turf/simulated/mineral/floor/ignore_cavegen/turfpack/muriki,
/area/mine/explored/muriki/cave/deepdark)
"q" = (
/obj/random/trash,
/turf/simulated/floor/plating/turfpack/muriki,
/area/mine/explored/muriki/cave/deepdark)
"r" = (
/turf/template_noop,
/area/template_noop)
"s" = (
/obj/effect/landmark/step_trap,
/turf/simulated/floor/plating/turfpack/muriki,
/area/mine/explored/muriki/cave/deepdark)
"u" = (
/obj/structure/trash_pile,
/turf/simulated/floor/plating/turfpack/muriki,
/area/mine/explored/muriki/cave/deepdark)
"z" = (
/obj/machinery/door/airlock/maintenance/int,
/obj/effect/landmark/step_trap,
/turf/simulated/floor/tiled/techfloor/turfpack/muriki,
/area/mine/explored/muriki/cave/deepdark)
"E" = (
/turf/simulated/wall,
/area/mine/explored/muriki/cave/deepdark)
"H" = (
/turf/simulated/floor/plating/turfpack/muriki,
/area/mine/explored/muriki/cave/deepdark)
"K" = (
/turf/template_noop,
/area/mine/explored/muriki/cave/deepdark)
"S" = (
/obj/structure/trash_pile,
/turf/simulated/mineral/floor/ignore_cavegen/turfpack/muriki,
/area/mine/explored/muriki/cave/deepdark)
"T" = (
/obj/machinery/trailblazer/yellow,
/turf/simulated/mineral/floor/ignore_cavegen/turfpack/muriki,
/area/mine/explored/muriki/cave/deepdark)

(1,1,1) = {"
r
r
r
r
r
r
r
r
r
r
r
r
r
r
r
r
r
r
r
r
r
r
r
r
r
"}
(2,1,1) = {"
r
a
a
a
a
a
a
a
a
a
a
a
a
a
a
a
a
a
a
a
a
H
E
a
r
"}
(3,1,1) = {"
r
a
a
a
a
a
a
a
a
a
a
a
a
a
a
a
a
a
a
a
E
H
K
a
r
"}
(4,1,1) = {"
r
a
a
a
a
a
a
a
a
a
a
a
a
a
a
a
a
a
a
a
K
H
E
a
r
"}
(5,1,1) = {"
r
a
a
a
a
a
a
a
a
a
a
a
a
a
a
a
a
a
a
a
E
q
E
a
r
"}
(6,1,1) = {"
r
a
a
a
a
a
a
a
a
a
a
a
a
a
a
a
a
a
a
a
E
s
E
a
r
"}
(7,1,1) = {"
r
a
a
a
a
a
a
a
a
a
a
a
a
a
a
a
a
a
a
a
E
H
E
a
r
"}
(8,1,1) = {"
r
a
a
a
a
a
a
a
a
a
a
a
a
a
a
a
a
a
a
a
S
H
E
a
r
"}
(9,1,1) = {"
r
a
a
a
a
a
a
a
a
a
a
a
a
a
a
a
a
a
a
a
T
H
K
a
r
"}
(10,1,1) = {"
r
a
a
a
a
a
a
a
a
a
a
a
a
a
a
a
a
a
a
a
o
H
E
a
r
"}
(11,1,1) = {"
r
a
a
a
a
a
a
a
a
a
a
a
a
a
a
a
a
a
a
a
E
H
E
a
r
"}
(12,1,1) = {"
r
a
a
a
a
a
a
a
a
a
a
a
a
a
a
a
a
a
a
a
E
n
E
a
r
"}
(13,1,1) = {"
r
a
a
a
a
K
E
E
E
E
E
E
E
K
u
E
E
E
E
E
H
H
E
E
r
"}
(14,1,1) = {"
r
a
a
a
a
H
H
z
H
q
H
H
q
q
H
s
n
H
H
H
H
E
u
E
r
"}
(15,1,1) = {"
r
a
a
a
a
K
E
E
E
o
o
E
E
E
E
E
E
E
K
E
H
q
q
E
r
"}
(16,1,1) = {"
r
a
a
a
a
a
a
a
a
a
T
a
a
a
a
a
a
a
a
a
E
n
E
a
r
"}
(17,1,1) = {"
r
a
a
a
a
a
a
a
a
a
a
a
a
a
a
a
a
a
a
a
K
H
E
a
r
"}
(18,1,1) = {"
r
a
a
a
a
a
a
a
a
a
a
a
a
a
a
a
a
a
a
a
K
H
E
a
r
"}
(19,1,1) = {"
r
a
a
a
a
a
a
a
a
a
a
a
a
a
a
a
a
a
a
T
o
H
E
a
r
"}
(20,1,1) = {"
r
a
a
a
a
a
a
a
a
a
a
a
a
a
a
a
a
a
a
a
E
s
E
a
r
"}
(21,1,1) = {"
r
a
a
a
a
a
a
a
a
a
a
a
a
a
a
a
a
a
a
a
E
q
E
a
r
"}
(22,1,1) = {"
r
a
a
a
a
a
a
a
a
a
a
a
a
a
a
a
a
a
a
a
E
H
E
a
r
"}
(23,1,1) = {"
r
a
a
a
a
a
a
a
a
a
a
a
a
a
a
a
a
a
a
a
E
a
a
a
r
"}
(24,1,1) = {"
r
a
a
a
a
a
a
a
a
a
a
a
a
a
a
a
a
a
a
a
a
a
a
a
r
"}
(25,1,1) = {"
r
r
r
r
r
r
r
r
r
r
r
r
r
r
r
r
r
r
r
r
r
r
r
r
r
"}
