//MAP CONVERTED BY dmm2tgm.py THIS HEADER COMMENT PREVENTS RECONVERSION, DO NOT REMOVE
"a" = (
/turf/template_noop,
/area/template_noop)
"g" = (
/obj/structure/table/steel_reinforced,
/turf/simulated/floor/plating/turfpack/muriki,
/area/mine/explored/muriki/cave/deepdark)
"h" = (
/obj/structure/target_stake,
/obj/item/target,
/turf/simulated/floor/plating/turfpack/muriki,
/area/mine/explored/muriki/cave/deepdark)
"l" = (
/obj/structure/target_stake,
/obj/item/target/syndicate,
/turf/simulated/floor/tiled/turfpack/muriki,
/area/mine/explored/muriki/cave/deepdark)
"m" = (
/obj/effect/auto_crayon{
	icon_state = "uboa"
	},
/turf/simulated/wall,
/area/mine/explored/muriki/cave/deepdark)
"n" = (
/obj/structure/target_stake,
/obj/item/target/alien,
/turf/simulated/floor/plating/turfpack/muriki,
/area/mine/explored/muriki/cave/deepdark)
"p" = (
/turf/simulated/floor/plating/turfpack/muriki,
/area/mine/explored/muriki/cave/deepdark)
"s" = (
/turf/simulated/mineral/alt/ignore_cavegen,
/area/mine/explored/muriki/cave/deepdark)
"x" = (
/obj/structure/table/steel_reinforced,
/obj/item/gun/launcher/crossbow/bow/hardlight,
/turf/simulated/floor/tiled/turfpack/muriki,
/area/mine/explored/muriki/cave/deepdark)
"F" = (
/mob/living/simple_mob/vore/aggressive/corrupthound/prettyboi,
/turf/simulated/floor/plating/turfpack/muriki,
/area/mine/explored/muriki/cave/deepdark)
"G" = (
/turf/simulated/floor/tiled/turfpack/muriki,
/area/mine/explored/muriki/cave/deepdark)
"J" = (
/obj/structure/loot_pile/mecha/marauder,
/turf/simulated/floor/tiled/turfpack/muriki,
/area/mine/explored/muriki/cave/deepdark)
"K" = (
/turf/simulated/mineral/alt/turfpack/muriki,
/area/mine/explored/muriki/cave/deepdark)
"R" = (
/obj/effect/landmark/dangerous_situation,
/turf/simulated/floor/plating/turfpack/muriki,
/area/mine/explored/muriki/cave/deepdark)
"V" = (
/obj/structure/table/steel_reinforced,
/turf/simulated/floor/tiled/turfpack/muriki,
/area/mine/explored/muriki/cave/deepdark)
"W" = (
/turf/simulated/wall,
/area/mine/explored/muriki/cave/deepdark)

(1,1,1) = {"
a
a
a
a
a
a
a
a
a
"}
(2,1,1) = {"
a
a
s
s
W
s
W
a
a
"}
(3,1,1) = {"
a
s
s
s
J
p
F
m
a
"}
(4,1,1) = {"
a
s
G
G
p
p
p
G
a
"}
(5,1,1) = {"
a
W
G
R
F
p
G
s
a
"}
(6,1,1) = {"
a
W
V
V
x
g
g
W
a
"}
(7,1,1) = {"
a
W
G
p
p
p
p
W
a
"}
(8,1,1) = {"
a
W
p
G
p
p
p
W
a
"}
(9,1,1) = {"
a
W
F
G
p
p
p
W
a
"}
(10,1,1) = {"
a
W
p
p
p
G
G
W
a
"}
(11,1,1) = {"
a
W
h
n
n
l
l
W
a
"}
(12,1,1) = {"
a
s
s
p
p
p
K
W
a
"}
(13,1,1) = {"
a
a
s
s
s
s
W
a
a
"}
(14,1,1) = {"
a
a
a
a
a
a
a
a
a
"}
