//MAP CONVERTED BY dmm2tgm.py THIS HEADER COMMENT PREVENTS RECONVERSION, DO NOT REMOVE
"a" = (
/turf/simulated/floor/wood/sif,
/area/mine/explored/muriki/cave/deepdark)
"d" = (
/turf/simulated/wall{
	can_open = 1
	},
/area/mine/explored/muriki/cave/deepdark)
"e" = (
/mob/living/simple_mob/vore/aggressive/rat{
	desc = "In what passes for a hierarchy among verminous rodents, this one is king, and oh lord is he chunky.";
	health = 350;
	name = "Kritch"
	},
/turf/simulated/floor/wood/sif,
/area/mine/explored/muriki/cave/deepdark)
"g" = (
/turf/simulated/wall,
/area/mine/explored/muriki/cave/deepdark)
"i" = (
/obj/effect/auto_crayon{
	icon_state = "up"
	},
/turf/simulated/floor/plating/turfpack/muriki,
/area/mine/explored/muriki/cave/deepdark)
"k" = (
/obj/item/storage/box/injectors{
	pixel_x = -5;
	pixel_y = 1
	},
/turf/simulated/floor/wood/sif,
/area/mine/explored/muriki/cave/deepdark)
"m" = (
/obj/structure/loot_pile/surface/bones,
/turf/simulated/floor/wood/sif,
/area/mine/explored/muriki/cave/deepdark)
"n" = (
/obj/structure/loot_pile/surface/bones,
/turf/simulated/floor/wood/sif/broken,
/area/mine/explored/muriki/cave/deepdark)
"o" = (
/obj/item/bone,
/turf/simulated/floor/wood/sif/broken,
/area/mine/explored/muriki/cave/deepdark)
"t" = (
/obj/item/bone/ribs,
/turf/simulated/floor/wood/sif,
/area/mine/explored/muriki/cave/deepdark)
"u" = (
/turf/simulated/floor/wood/sif/broken,
/area/mine/explored/muriki/cave/deepdark)
"v" = (
/obj/item/bone/skull/unknown,
/turf/simulated/floor/wood/sif,
/area/mine/explored/muriki/cave/deepdark)
"z" = (
/obj/item/bone/arm,
/turf/simulated/floor/wood/sif,
/area/mine/explored/muriki/cave/deepdark)
"G" = (
/obj/item/bone/skull,
/turf/simulated/floor/wood/sif/broken,
/area/mine/explored/muriki/cave/deepdark)
"H" = (
/turf/template_noop,
/area/template_noop)
"N" = (
/obj/structure/loot_pile/mecha/ripley/random_sprite,
/turf/simulated/floor/wood/sif,
/area/mine/explored/muriki/cave/deepdark)
"P" = (
/obj/effect/auto_crayon{
	icon_state = "x"
	},
/turf/simulated/floor/plating/turfpack/muriki,
/area/mine/explored/muriki/cave/deepdark)
"T" = (
/obj/structure/loot_pile/mecha/gygax/dark,
/turf/simulated/floor/wood/sif,
/area/mine/explored/muriki/cave/deepdark)
"U" = (
/obj/item/bone/skull/tajaran,
/turf/simulated/floor/wood/sif/broken,
/area/mine/explored/muriki/cave/deepdark)
"V" = (
/turf/simulated/mineral/alt/ignore_cavegen,
/area/mine/explored/muriki/cave/deepdark)
"W" = (
/obj/item/bone/skull/unathi,
/turf/simulated/floor/wood/sif,
/area/mine/explored/muriki/cave/deepdark)
"X" = (
/obj/effect/landmark/loot_spawn,
/turf/simulated/floor/wood/sif,
/area/mine/explored/muriki/cave/deepdark)

(1,1,1) = {"
H
H
H
H
H
H
H
H
H
H
"}
(2,1,1) = {"
H
g
g
g
g
g
g
g
H
H
"}
(3,1,1) = {"
H
g
u
u
a
a
u
g
V
H
"}
(4,1,1) = {"
H
g
N
a
v
u
a
d
P
H
"}
(5,1,1) = {"
H
g
k
a
a
o
a
d
i
H
"}
(6,1,1) = {"
H
g
a
a
m
u
a
g
V
H
"}
(7,1,1) = {"
H
g
a
u
e
a
U
g
H
H
"}
(8,1,1) = {"
H
g
a
z
W
a
a
g
H
H
"}
(9,1,1) = {"
H
g
T
u
G
t
u
g
V
H
"}
(10,1,1) = {"
H
g
X
a
u
n
a
g
V
H
"}
(11,1,1) = {"
H
g
a
a
a
a
a
g
V
H
"}
(12,1,1) = {"
H
g
g
g
g
g
g
g
H
H
"}
(13,1,1) = {"
H
H
H
H
H
H
H
H
H
H
"}
