//MAP CONVERTED BY dmm2tgm.py THIS HEADER COMMENT PREVENTS RECONVERSION, DO NOT REMOVE
"a" = (
/turf/simulated/mineral/alt/ignore_mapgen/turfpack/muriki,
/area/template_noop)
"b" = (
/turf/simulated/floor/plating/turfpack/muriki,
/area/mine/explored/muriki/cave/deepdark)
"c" = (
/obj/random/cutout,
/turf/simulated/floor/plating/turfpack/muriki,
/area/mine/explored/muriki/cave/deepdark)
"e" = (
/obj/structure/table/woodentable,
/obj/item/bone/skull/unathi,
/turf/simulated/floor/plating/turfpack/muriki,
/area/mine/explored/muriki/cave/deepdark)
"g" = (
/obj/machinery/light/small,
/turf/simulated/floor/plating/turfpack/muriki,
/area/mine/explored/muriki/cave/deepdark)
"i" = (
/obj/effect/recycler_vendor_beacon,
/turf/simulated/floor/plating/turfpack/muriki,
/area/mine/explored/muriki/cave/deepdark)
"j" = (
/obj/effect/recycler_beacon,
/turf/simulated/floor/plating/turfpack/muriki,
/area/mine/explored/muriki/cave/deepdark)
"m" = (
/turf/template_noop,
/area/mine/explored/muriki/cave/deepdark)
"x" = (
/obj/item/bone/ribs,
/obj/item/bone,
/obj/item/bone,
/turf/simulated/floor/plating/turfpack/muriki,
/area/mine/explored/muriki/cave/deepdark)
"y" = (
/obj/item/digestion_remains/skull/unknown/anthro,
/turf/simulated/floor/plating/turfpack/muriki,
/area/mine/explored/muriki/cave/deepdark)
"A" = (
/turf/simulated/mineral/floor/ignore_cavegen/turfpack/muriki,
/area/template_noop)
"B" = (
/obj/effect/landmark/loot_spawn/low,
/turf/simulated/floor/plating/turfpack/muriki,
/area/mine/explored/muriki/cave/deepdark)
"F" = (
/obj/effect/landmark/dangerous_situation,
/turf/simulated/floor/plating/turfpack/muriki,
/area/mine/explored/muriki/cave/deepdark)
"G" = (
/obj/machinery/door/airlock/maintenance/common,
/turf/simulated/floor/plating/turfpack/muriki,
/area/mine/explored/muriki/cave/deepdark)
"K" = (
/obj/structure/table/woodentable,
/obj/item/lasertagknife,
/turf/simulated/floor/plating/turfpack/muriki,
/area/mine/explored/muriki/cave/deepdark)
"L" = (
/turf/simulated/mineral/alt/ignore_mapgen/turfpack/muriki,
/area/mine/explored/muriki/cave/deepdark)
"O" = (
/obj/structure/table/woodentable,
/obj/item/bone/skull,
/turf/simulated/floor/plating/turfpack/muriki,
/area/mine/explored/muriki/cave/deepdark)
"P" = (
/obj/structure/table/woodentable,
/turf/simulated/floor/plating/turfpack/muriki,
/area/mine/explored/muriki/cave/deepdark)
"Q" = (
/turf/simulated/wall,
/area/mine/explored/muriki/cave/deepdark)
"U" = (
/turf/simulated/mineral/floor/ignore_cavegen/turfpack/muriki,
/area/mine/explored/muriki/cave/deepdark)
"X" = (
/turf/template_noop,
/area/template_noop)

(1,1,1) = {"
X
X
X
X
X
X
X
X
X
X
X
X
X
X
X
"}
(2,1,1) = {"
X
X
X
X
X
X
L
L
m
X
X
X
X
X
X
"}
(3,1,1) = {"
X
X
X
a
L
L
L
L
L
L
L
m
X
X
X
"}
(4,1,1) = {"
X
X
a
L
L
Q
Q
Q
L
L
L
L
m
X
X
"}
(5,1,1) = {"
X
X
a
L
L
Q
O
B
L
L
L
L
L
X
X
"}
(6,1,1) = {"
X
X
a
L
L
Q
b
b
b
L
L
L
L
a
X
"}
(7,1,1) = {"
X
X
X
L
L
Q
i
F
b
b
L
L
L
L
X
"}
(8,1,1) = {"
X
X
X
a
L
Q
b
y
b
g
Q
L
U
m
X
"}
(9,1,1) = {"
X
X
X
X
L
Q
j
F
b
b
Q
U
U
m
X
"}
(10,1,1) = {"
X
X
X
a
L
Q
e
x
b
b
G
U
U
U
X
"}
(11,1,1) = {"
X
X
X
a
L
Q
K
P
P
c
Q
L
U
A
X
"}
(12,1,1) = {"
X
X
X
a
L
Q
Q
Q
Q
Q
Q
L
a
X
X
"}
(13,1,1) = {"
X
X
X
a
X
L
L
L
L
L
L
L
a
X
X
"}
(14,1,1) = {"
X
X
X
X
X
X
X
L
L
m
X
X
X
X
X
"}
(15,1,1) = {"
X
X
X
X
X
X
X
X
X
X
X
X
X
X
X
"}
