//MAP CONVERTED BY dmm2tgm.py THIS HEADER COMMENT PREVENTS RECONVERSION, DO NOT REMOVE
"a" = (
/turf/simulated/floor/cult,
/area/mine/explored/muriki/cave/deepdark)
"b" = (
/turf/simulated/floor/wood,
/area/mine/explored/muriki/cave/deepdark)
"f" = (
/obj/effect/decal/cleanable/blood/gibs,
/obj/structure/kitchenspike,
/turf/simulated/floor/cult,
/area/mine/explored/muriki/cave/deepdark)
"g" = (
/obj/item/clothing/under/punpun,
/obj/effect/decal/cleanable/blood/gibs,
/obj/effect/decal/cleanable/blood/gibs,
/turf/simulated/floor/cult,
/area/mine/explored/muriki/cave/deepdark)
"h" = (
/obj/effect/auto_crayon{
	icon_state = "rune1"
	},
/turf/simulated/floor/plating/turfpack/muriki,
/area/mine/explored/muriki/cave/deepdark)
"n" = (
/obj/item/clothing/under/punpun,
/obj/effect/decal/cleanable/blood/gibs,
/turf/simulated/floor/cult,
/area/mine/explored/muriki/cave/deepdark)
"s" = (
/obj/effect/decal/cleanable/blood,
/obj/structure/cult/talisman,
/obj/item/material/knife/ritual{
	name = "The Punpun-isher"
	},
/turf/simulated/floor/cult,
/area/mine/explored/muriki/cave/deepdark)
"u" = (
/obj/structure/table/woodentable,
/obj/item/flame/candle/candelabra/everburn,
/turf/simulated/floor/cult,
/area/mine/explored/muriki/cave/deepdark)
"x" = (
/obj/effect/decal/cleanable/blood,
/obj/structure/table/woodentable,
/obj/item/flame/candle/candelabra/everburn,
/turf/simulated/floor/cult,
/area/mine/explored/muriki/cave/deepdark)
"B" = (
/turf/template_noop,
/area/template_noop)
"D" = (
/obj/item/clothing/under/punpun,
/obj/item/clothing/under/punpun,
/obj/effect/decal/cleanable/blood/gibs,
/turf/simulated/floor/cult,
/area/mine/explored/muriki/cave/deepdark)
"G" = (
/turf/simulated/wall,
/area/mine/explored/muriki/cave/deepdark)
"I" = (
/obj/structure/kitchenspike,
/turf/simulated/floor/cult,
/area/mine/explored/muriki/cave/deepdark)
"J" = (
/obj/item/clothing/under/punpun,
/obj/effect/decal/cleanable/blood,
/turf/simulated/floor/cult,
/area/mine/explored/muriki/cave/deepdark)
"K" = (
/obj/item/clothing/under/punpun,
/turf/simulated/floor/cult,
/area/mine/explored/muriki/cave/deepdark)
"M" = (
/obj/effect/decal/cleanable/blood,
/turf/simulated/floor/cult,
/area/mine/explored/muriki/cave/deepdark)
"N" = (
/obj/effect/decal/cleanable/blood/gibs,
/turf/simulated/floor/cult,
/area/mine/explored/muriki/cave/deepdark)
"R" = (
/obj/machinery/door/airlock/hatch,
/turf/simulated/floor/wood,
/area/mine/explored/muriki/cave/deepdark)
"S" = (
/obj/structure/simple_door/cult,
/turf/simulated/floor/wood,
/area/mine/explored/muriki/cave/deepdark)
"U" = (
/obj/effect/decal/cleanable/blood,
/obj/structure/kitchenspike,
/turf/simulated/floor/cult,
/area/mine/explored/muriki/cave/deepdark)
"W" = (
/turf/simulated/mineral/alt/turfpack/muriki,
/area/mine/explored/muriki/cave/deepdark)
"X" = (
/obj/item/clothing/under/punpun,
/obj/item/clothing/under/punpun,
/obj/item/clothing/under/punpun,
/obj/effect/decal/cleanable/blood,
/turf/simulated/floor/cult,
/area/mine/explored/muriki/cave/deepdark)
"Z" = (
/obj/structure/cult/talisman,
/obj/item/flame/candle/everburn,
/turf/simulated/floor/cult,
/area/mine/explored/muriki/cave/deepdark)

(1,1,1) = {"
B
B
B
B
B
B
B
B
B
B
B
B
B
"}
(2,1,1) = {"
B
B
B
W
W
G
G
G
G
G
G
G
B
"}
(3,1,1) = {"
B
B
W
W
W
G
x
U
f
I
u
G
B
"}
(4,1,1) = {"
B
B
W
W
W
G
K
D
a
J
M
G
B
"}
(5,1,1) = {"
B
G
G
G
G
G
M
N
a
a
Z
G
B
"}
(6,1,1) = {"
B
h
R
b
b
S
N
a
a
N
s
G
B
"}
(7,1,1) = {"
B
W
G
G
G
G
a
g
X
M
Z
G
B
"}
(8,1,1) = {"
B
W
W
W
W
G
N
K
n
M
a
G
B
"}
(9,1,1) = {"
B
B
W
W
W
G
u
I
I
I
u
G
B
"}
(10,1,1) = {"
B
B
B
B
W
G
G
G
G
G
G
G
B
"}
(11,1,1) = {"
B
B
B
B
B
B
B
B
B
B
B
B
B
"}
