//MAP CONVERTED BY dmm2tgm.py THIS HEADER COMMENT PREVENTS RECONVERSION, DO NOT REMOVE
"a" = (
/turf/template_noop,
/area/mine/unexplored/muriki/cave/deepdark)
"h" = (
/obj/effect/landmark/hostile_xenobio,
/turf/simulated/mineral/floor/ignore_cavegen/turfpack/muriki,
/area/mine/unexplored/muriki/cave/deepdark)
"q" = (
/turf/template_noop,
/area/template_noop)
"u" = (
/obj/structure/trash_pile,
/turf/simulated/mineral/floor/ignore_cavegen/turfpack/muriki,
/area/mine/unexplored/muriki/cave/deepdark)
"F" = (
/turf/simulated/mineral/floor/ignore_cavegen/turfpack/muriki,
/area/mine/unexplored/muriki/cave/deepdark)
"Q" = (
/obj/machinery/trailblazer/yellow,
/turf/simulated/mineral/floor/ignore_cavegen/turfpack/muriki,
/area/mine/unexplored/muriki/cave/deepdark)
"R" = (
/obj/structure/prop/rock/flat,
/turf/simulated/mineral/floor/ignore_cavegen/turfpack/muriki,
/area/mine/unexplored/muriki/cave/deepdark)
"Z" = (
/obj/structure/prop/rock/small,
/turf/simulated/mineral/floor/ignore_cavegen/turfpack/muriki,
/area/mine/unexplored/muriki/cave/deepdark)

(1,1,1) = {"
q
q
q
q
q
q
q
q
q
q
q
q
q
q
q
q
q
q
q
q
q
q
q
q
q
"}
(2,1,1) = {"
q
a
a
a
a
a
a
a
a
a
a
a
a
a
a
a
a
a
a
a
a
a
a
a
q
"}
(3,1,1) = {"
q
a
a
a
a
a
a
a
a
a
a
a
a
a
a
F
Z
F
F
F
F
a
a
a
q
"}
(4,1,1) = {"
q
a
a
a
a
a
a
a
a
a
a
a
a
a
a
F
F
F
Z
Z
Q
F
a
a
q
"}
(5,1,1) = {"
q
a
a
a
a
a
a
a
a
a
a
a
F
F
u
F
R
F
F
h
Z
Z
a
a
q
"}
(6,1,1) = {"
q
a
a
a
a
a
a
a
a
a
a
Z
Z
F
R
Z
F
Z
F
R
F
F
a
a
q
"}
(7,1,1) = {"
q
a
a
a
a
a
a
a
a
a
a
Z
F
Z
F
Q
F
F
u
Z
Z
R
a
a
q
"}
(8,1,1) = {"
q
a
a
a
a
a
a
a
a
a
a
F
F
Z
R
F
Z
Z
F
F
Z
a
a
a
q
"}
(9,1,1) = {"
q
a
a
a
a
a
a
a
a
a
a
a
F
F
Z
F
F
R
Z
F
a
a
a
a
q
"}
(10,1,1) = {"
q
a
a
a
a
a
a
a
a
a
a
a
F
u
F
Z
F
F
F
a
a
a
a
a
q
"}
(11,1,1) = {"
q
a
a
a
a
a
a
a
a
a
a
a
F
F
F
a
a
a
a
a
a
a
a
a
q
"}
(12,1,1) = {"
q
a
a
a
F
Z
F
F
F
a
a
a
a
a
a
a
a
a
a
a
a
a
a
a
q
"}
(13,1,1) = {"
q
a
a
F
Z
Z
Z
F
Z
F
F
a
a
a
a
a
a
a
a
a
a
a
a
a
q
"}
(14,1,1) = {"
q
a
a
F
u
R
F
F
Z
Z
Z
a
a
a
a
a
a
a
a
a
a
a
a
a
q
"}
(15,1,1) = {"
q
a
F
Z
Q
Z
F
R
F
Z
F
a
a
a
a
a
R
Z
Z
F
a
a
a
a
q
"}
(16,1,1) = {"
q
a
F
Z
F
F
R
Z
Z
R
F
F
a
a
a
a
Z
F
R
Z
F
F
a
a
q
"}
(17,1,1) = {"
q
a
F
F
R
Z
F
F
Z
F
F
Z
a
a
a
Z
Z
F
F
Q
F
Z
a
a
q
"}
(18,1,1) = {"
q
a
F
F
Z
Z
Z
F
R
u
Z
Z
a
a
a
F
R
u
Z
R
F
Z
a
a
q
"}
(19,1,1) = {"
q
a
a
F
F
Z
F
F
h
Q
F
F
a
a
a
Z
F
Z
Z
Z
F
F
a
a
q
"}
(20,1,1) = {"
q
a
a
a
a
a
F
Z
Z
F
Z
a
a
a
a
a
a
F
R
F
R
a
a
a
q
"}
(21,1,1) = {"
q
a
a
a
a
a
F
F
Z
F
F
a
a
a
a
a
a
F
Z
F
Z
a
a
a
q
"}
(22,1,1) = {"
q
a
a
a
a
a
a
a
a
a
a
a
a
a
a
a
a
a
a
a
a
a
a
a
q
"}
(23,1,1) = {"
q
a
a
a
a
a
a
a
a
a
a
a
a
a
a
a
a
a
a
a
a
a
a
a
q
"}
(24,1,1) = {"
q
a
a
a
a
a
a
a
a
a
a
a
a
a
a
a
a
a
a
a
a
a
a
a
q
"}
(25,1,1) = {"
q
q
q
q
q
q
q
q
q
q
q
q
q
q
q
q
q
q
q
q
q
q
q
q
q
"}
