//MAP CONVERTED BY dmm2tgm.py THIS HEADER COMMENT PREVENTS RECONVERSION, DO NOT REMOVE
"a" = (
/turf/template_noop,
/area/template_noop)
"f" = (
/obj/structure/prop/rock/flat,
/turf/simulated/mineral/floor/ignore_cavegen/turfpack/muriki,
/area/mine/unexplored/muriki/cave/deepdark)
"g" = (
/obj/effect/landmark/hostile_xenobio,
/turf/simulated/mineral/floor/ignore_cavegen/turfpack/muriki,
/area/mine/unexplored/muriki/cave/deepdark)
"i" = (
/turf/simulated/mineral/floor/ignore_cavegen/turfpack/muriki,
/area/mine/unexplored/muriki/cave/deepdark)
"l" = (
/obj/structure/prop/rock/small,
/turf/simulated/mineral/floor/ignore_cavegen/turfpack/muriki,
/area/mine/unexplored/muriki/cave/deepdark)
"A" = (
/obj/structure/trash_pile,
/turf/simulated/mineral/floor/ignore_cavegen/turfpack/muriki,
/area/mine/unexplored/muriki/cave/deepdark)
"C" = (
/obj/machinery/trailblazer/yellow,
/turf/simulated/mineral/floor/ignore_cavegen/turfpack/muriki,
/area/mine/unexplored/muriki/cave/deepdark)
"G" = (
/turf/template_noop,
/area/mine/unexplored/muriki/cave/deepdark)

(1,1,1) = {"
a
a
a
a
a
a
a
a
a
a
a
a
a
a
a
a
a
a
a
a
a
a
a
a
a
a
a
a
a
a
a
a
a
a
a
"}
(2,1,1) = {"
a
G
G
G
G
G
G
G
G
G
G
G
G
G
G
G
G
G
G
G
G
G
G
G
G
G
G
G
G
G
G
G
G
G
a
"}
(3,1,1) = {"
a
G
G
G
G
G
G
G
G
G
G
G
G
G
G
G
G
G
G
G
G
G
G
G
G
G
G
G
G
G
G
G
G
G
a
"}
(4,1,1) = {"
a
G
G
G
G
G
G
G
G
G
G
G
G
G
G
G
G
G
G
G
G
G
G
G
G
G
G
G
G
G
G
G
G
G
a
"}
(5,1,1) = {"
a
G
G
G
G
G
G
G
G
G
G
G
G
G
G
G
G
G
G
G
G
G
G
G
G
G
G
G
G
G
G
G
G
G
a
"}
(6,1,1) = {"
a
G
G
G
G
G
G
G
G
G
G
G
G
G
G
G
G
G
G
i
f
i
G
G
G
G
G
G
G
G
G
G
G
G
a
"}
(7,1,1) = {"
a
G
G
G
G
G
G
G
G
G
G
G
G
G
G
G
G
G
G
f
l
l
G
G
G
G
G
G
G
G
G
G
G
G
a
"}
(8,1,1) = {"
a
G
G
G
G
G
G
i
l
i
i
i
G
G
G
G
G
i
l
i
i
l
G
G
G
G
G
G
G
G
G
G
G
G
a
"}
(9,1,1) = {"
a
G
G
G
G
G
i
l
l
l
i
l
i
i
G
G
G
i
i
l
g
f
l
l
C
G
G
G
G
G
G
G
G
G
a
"}
(10,1,1) = {"
a
G
G
G
G
G
i
A
f
i
A
i
f
i
G
G
G
i
f
A
i
i
i
i
l
G
G
G
G
G
G
G
G
G
a
"}
(11,1,1) = {"
a
G
G
G
G
i
l
C
i
i
f
l
i
l
G
G
G
l
i
l
i
i
i
f
i
i
i
G
G
G
G
G
G
G
a
"}
(12,1,1) = {"
a
G
G
G
i
i
l
l
i
l
i
C
i
i
G
G
G
G
G
G
i
i
i
i
f
i
l
G
G
G
G
G
G
G
a
"}
(13,1,1) = {"
a
G
G
G
G
i
i
i
i
l
f
i
l
l
G
G
G
G
G
i
f
i
i
i
l
i
l
G
G
G
G
G
G
G
a
"}
(14,1,1) = {"
a
G
G
G
G
G
G
G
i
i
l
i
i
f
G
G
G
G
G
l
i
l
i
f
i
i
i
G
G
G
G
G
G
G
a
"}
(15,1,1) = {"
a
G
G
G
G
G
G
G
i
i
l
i
i
G
G
G
G
G
G
C
i
i
A
l
l
f
G
G
G
G
G
G
G
G
a
"}
(16,1,1) = {"
a
G
G
G
G
G
G
G
G
G
G
G
G
G
G
G
G
G
G
i
l
l
i
i
l
G
G
G
G
G
G
G
G
G
a
"}
(17,1,1) = {"
a
G
G
G
G
G
G
G
G
G
G
G
G
G
G
G
G
G
G
G
l
i
l
l
l
G
G
G
G
G
G
G
G
G
a
"}
(18,1,1) = {"
a
G
G
G
G
G
G
G
G
G
G
G
G
G
G
G
G
G
G
G
G
G
G
G
G
G
G
G
G
G
G
G
G
G
a
"}
(19,1,1) = {"
a
G
G
G
G
G
G
G
G
G
G
G
G
G
G
G
G
G
G
G
G
G
G
G
G
G
G
G
G
G
G
G
G
G
a
"}
(20,1,1) = {"
a
G
G
G
G
G
G
G
G
G
G
G
G
i
i
l
l
l
G
G
G
G
G
G
G
G
G
G
G
G
G
G
G
G
a
"}
(21,1,1) = {"
a
G
G
G
G
G
G
G
G
G
G
G
G
i
f
i
l
i
G
G
G
G
G
G
G
G
G
G
G
G
G
G
G
G
a
"}
(22,1,1) = {"
a
G
G
G
G
G
G
G
G
G
G
G
G
f
l
l
f
i
i
G
G
G
G
G
G
G
G
G
G
G
G
G
G
G
a
"}
(23,1,1) = {"
a
G
G
G
G
G
G
G
G
G
G
i
l
i
i
l
i
i
l
G
G
G
G
G
G
G
G
G
G
G
G
G
G
G
a
"}
(24,1,1) = {"
a
G
G
G
G
G
G
G
G
G
G
i
i
l
i
f
A
l
l
G
G
G
G
i
i
l
l
C
i
G
G
G
G
G
a
"}
(25,1,1) = {"
a
G
G
G
G
G
G
G
i
i
A
i
f
i
i
i
C
i
i
G
G
G
i
f
i
i
i
l
l
G
G
G
G
G
a
"}
(26,1,1) = {"
a
G
G
G
G
G
G
l
l
i
f
l
i
l
i
f
i
i
G
G
G
G
l
i
l
i
f
i
i
i
G
G
G
G
a
"}
(27,1,1) = {"
a
G
G
G
G
G
G
l
i
l
i
C
i
i
A
l
l
f
G
G
G
G
C
i
i
A
l
l
f
l
G
G
G
G
a
"}
(28,1,1) = {"
a
G
G
G
G
G
G
i
i
l
f
g
l
l
i
i
l
G
G
G
G
G
i
l
l
i
i
l
G
l
G
G
G
G
a
"}
(29,1,1) = {"
a
G
G
G
G
G
G
G
i
i
l
i
i
f
l
i
G
G
G
G
G
G
G
l
i
l
l
l
G
G
G
G
G
G
a
"}
(30,1,1) = {"
a
G
G
G
G
G
G
G
i
A
i
l
i
i
i
G
G
G
G
G
G
G
G
G
G
i
f
i
f
G
G
G
G
G
a
"}
(31,1,1) = {"
a
G
G
G
G
G
G
G
i
i
i
G
G
G
G
G
G
G
G
G
G
G
G
G
G
i
l
i
l
G
G
G
G
G
a
"}
(32,1,1) = {"
a
G
G
G
G
G
G
G
G
G
G
G
G
G
G
G
G
G
G
G
G
G
G
G
G
G
G
G
G
G
G
G
G
G
a
"}
(33,1,1) = {"
a
G
G
G
G
G
G
G
G
G
G
G
G
G
G
G
G
G
G
G
G
G
G
G
G
G
G
G
G
G
G
G
G
G
a
"}
(34,1,1) = {"
a
G
G
G
G
G
G
G
G
G
G
G
G
G
G
G
G
G
G
G
G
G
G
G
G
G
G
G
G
G
G
G
G
G
a
"}
(35,1,1) = {"
a
a
a
a
a
a
a
a
a
a
a
a
a
a
a
a
a
a
a
a
a
a
a
a
a
a
a
a
a
a
a
a
a
a
a
"}
