//MAP CONVERTED BY dmm2tgm.py THIS HEADER COMMENT PREVENTS RECONVERSION, DO NOT REMOVE
"a" = (
/turf/simulated/mineral/alt/ignore_mapgen/turfpack/muriki,
/area/mine/explored/muriki/cave/deepdark)
"e" = (
/mob/living/simple_mob/animal/giant_spider/frost,
/turf/simulated/mineral/floor/ignore_cavegen/turfpack/muriki,
/area/mine/explored/muriki/cave/deepdark)
"j" = (
/turf/simulated/mineral/floor/ignore_cavegen/turfpack/muriki,
/area/mine/explored/muriki/cave/deepdark)
"l" = (
/obj/random/ammo,
/turf/simulated/mineral/floor/ignore_cavegen/turfpack/muriki,
/area/mine/explored/muriki/cave/deepdark)
"o" = (
/mob/living/simple_mob/animal/giant_spider,
/obj/random/humanoidremains,
/obj/random/contraband,
/turf/simulated/mineral/floor/ignore_cavegen/turfpack/muriki,
/area/mine/explored/muriki/cave/deepdark)
"r" = (
/obj/random/gun/random,
/obj/structure/loot_pile/surface/bones,
/turf/simulated/mineral/floor/ignore_cavegen/turfpack/muriki,
/area/mine/explored/muriki/cave/deepdark)
"s" = (
/obj/structure/loot_pile/surface/bones,
/turf/simulated/mineral/floor/ignore_cavegen/turfpack/muriki,
/area/mine/explored/muriki/cave/deepdark)
"u" = (
/mob/living/simple_mob/animal/giant_spider/nurse,
/obj/random/contraband,
/turf/simulated/mineral/floor/ignore_cavegen/turfpack/muriki,
/area/mine/explored/muriki/cave/deepdark)
"v" = (
/turf/template_noop,
/area/mine/explored/muriki/cave/deepdark)
"w" = (
/obj/effect/spider/stickyweb,
/turf/simulated/mineral/floor/ignore_cavegen/turfpack/muriki,
/area/mine/explored/muriki/cave/deepdark)
"A" = (
/obj/random/contraband,
/turf/simulated/mineral/floor/ignore_cavegen/turfpack/muriki,
/area/mine/explored/muriki/cave/deepdark)
"C" = (
/obj/random/humanoidremains,
/obj/random/contraband,
/turf/simulated/mineral/floor/ignore_cavegen/turfpack/muriki,
/area/mine/explored/muriki/cave/deepdark)
"D" = (
/mob/living/simple_mob/animal/giant_spider/broodmother,
/turf/simulated/mineral/floor/ignore_cavegen/turfpack/muriki,
/area/mine/explored/muriki/cave/deepdark)
"F" = (
/mob/living/simple_mob/animal/giant_spider/nurse,
/turf/simulated/mineral/floor/ignore_cavegen/turfpack/muriki,
/area/mine/explored/muriki/cave/deepdark)
"J" = (
/mob/living/simple_mob/animal/giant_spider,
/turf/simulated/mineral/floor/ignore_cavegen/turfpack/muriki,
/area/mine/explored/muriki/cave/deepdark)
"K" = (
/turf/template_noop,
/area/template_noop)
"L" = (
/mob/living/simple_mob/animal/giant_spider/electric,
/turf/simulated/mineral/floor/ignore_cavegen/turfpack/muriki,
/area/mine/explored/muriki/cave/deepdark)
"N" = (
/obj/random/awayloot/nofail,
/turf/simulated/mineral/floor/ignore_cavegen/turfpack/muriki,
/area/mine/explored/muriki/cave/deepdark)
"Q" = (
/obj/random/gun/random,
/turf/simulated/mineral/floor/ignore_cavegen/turfpack/muriki,
/area/mine/explored/muriki/cave/deepdark)
"R" = (
/mob/living/simple_mob/animal/giant_spider/hunter,
/obj/random/contraband,
/turf/simulated/mineral/floor/ignore_cavegen/turfpack/muriki,
/area/mine/explored/muriki/cave/deepdark)
"S" = (
/obj/random/multiple/underdark/miningdrills,
/turf/simulated/mineral/floor/ignore_cavegen/turfpack/muriki,
/area/mine/explored/muriki/cave/deepdark)
"U" = (
/obj/effect/spider/stickyweb,
/obj/random/ammo,
/turf/simulated/mineral/floor/ignore_cavegen/turfpack/muriki,
/area/mine/explored/muriki/cave/deepdark)
"X" = (
/mob/living/simple_mob/animal/giant_spider/electric,
/obj/random/awayloot/nofail,
/turf/simulated/mineral/floor/ignore_cavegen/turfpack/muriki,
/area/mine/explored/muriki/cave/deepdark)

(1,1,1) = {"
K
K
K
K
K
K
K
K
K
K
K
K
K
K
K
K
K
K
K
K
"}
(2,1,1) = {"
K
v
a
j
j
a
a
a
a
v
a
a
a
F
j
a
a
v
v
K
"}
(3,1,1) = {"
K
a
a
l
F
j
w
a
a
a
a
a
j
j
a
a
a
v
v
K
"}
(4,1,1) = {"
K
a
a
j
J
s
l
w
a
a
a
a
l
J
j
w
a
v
v
K
"}
(5,1,1) = {"
K
a
a
a
a
j
j
J
j
j
a
a
e
S
l
w
a
a
v
K
"}
(6,1,1) = {"
K
v
a
a
a
w
w
j
C
Q
a
a
A
r
J
w
a
a
v
K
"}
(7,1,1) = {"
K
v
a
a
a
a
a
a
l
j
j
j
j
j
j
a
a
a
v
K
"}
(8,1,1) = {"
K
v
a
a
w
j
a
a
w
j
X
s
A
j
w
a
a
a
a
K
"}
(9,1,1) = {"
K
j
a
j
A
S
j
a
a
a
j
A
j
j
a
a
w
a
a
K
"}
(10,1,1) = {"
K
j
j
j
s
J
l
a
a
a
s
j
D
j
s
j
l
j
a
K
"}
(11,1,1) = {"
K
j
j
j
j
j
j
j
l
j
u
j
s
N
e
j
j
J
a
K
"}
(12,1,1) = {"
K
a
a
U
Q
j
R
j
j
N
j
S
A
F
j
j
l
j
j
K
"}
(13,1,1) = {"
K
a
a
a
a
j
j
a
a
j
j
a
a
a
w
s
o
j
j
K
"}
(14,1,1) = {"
K
v
v
a
a
w
w
a
a
L
j
w
a
a
j
Q
j
j
a
K
"}
(15,1,1) = {"
K
v
v
a
a
a
a
a
a
A
j
j
a
a
a
w
w
a
a
K
"}
(16,1,1) = {"
K
v
v
v
v
a
a
a
w
Q
s
j
w
a
a
a
a
a
a
K
"}
(17,1,1) = {"
K
v
v
v
a
a
a
j
s
j
J
l
j
a
a
a
a
a
v
K
"}
(18,1,1) = {"
K
v
v
v
a
a
a
j
J
j
F
j
a
a
a
a
v
v
v
K
"}
(19,1,1) = {"
K
v
v
v
v
v
a
a
a
j
j
a
a
a
v
v
v
v
v
K
"}
(20,1,1) = {"
K
K
K
K
K
K
K
K
K
K
K
K
K
K
K
K
K
K
K
K
"}
