//MAP CONVERTED BY dmm2tgm.py THIS HEADER COMMENT PREVENTS RECONVERSION, DO NOT REMOVE
"a" = (
/turf/simulated/mineral/floor/ignore_cavegen/turfpack/muriki,
/area/mine/explored/muriki/cave/deepdark)
"j" = (
/turf/simulated/mineral/floor/ignore_cavegen/turfpack/muriki,
/area/mine/unexplored/muriki/cave/deepdark)
"o" = (
/turf/template_noop,
/area/template_noop)
"r" = (
/turf/simulated/mineral/alt/ignore_mapgen/turfpack/muriki,
/area/mine/unexplored/muriki/cave/deepdark)
"L" = (
/turf/simulated/mineral/alt/ignore_mapgen/turfpack/muriki,
/area/mine/explored/muriki/cave/deepdark)
"S" = (
/obj/effect/decal/mecha_wreckage/submarine/old,
/turf/simulated/mineral/floor/ignore_cavegen/turfpack/muriki,
/area/mine/explored/muriki/cave/deepdark)
"V" = (
/turf/template_noop,
/area/mine/unexplored/muriki/cave/deepdark)

(1,1,1) = {"
o
o
o
o
o
o
o
o
o
o
o
o
"}
(2,1,1) = {"
o
V
j
j
r
j
j
j
r
r
V
o
"}
(3,1,1) = {"
o
j
a
L
L
L
a
a
L
L
r
o
"}
(4,1,1) = {"
o
r
L
L
L
L
a
a
a
L
r
o
"}
(5,1,1) = {"
o
r
L
L
a
a
a
a
a
a
j
o
"}
(6,1,1) = {"
o
V
L
a
a
a
a
S
a
a
j
o
"}
(7,1,1) = {"
o
V
a
a
a
a
a
a
a
a
V
o
"}
(8,1,1) = {"
o
j
a
a
a
a
a
a
a
a
j
o
"}
(9,1,1) = {"
o
j
a
a
a
a
L
a
a
a
j
o
"}
(10,1,1) = {"
o
j
a
a
L
L
L
a
a
a
r
o
"}
(11,1,1) = {"
o
V
j
j
j
r
j
j
j
j
V
o
"}
(12,1,1) = {"
o
o
o
o
o
o
o
o
o
o
o
o
"}
