//MAP CONVERTED BY dmm2tgm.py THIS HEADER COMMENT PREVENTS RECONVERSION, DO NOT REMOVE
"a" = (
/turf/simulated/floor/maglev{
	icon_state = "maglevside"
	},
/area/mine/unexplored/muriki/cave/deepdark)
"c" = (
/obj/effect/shuttle_landmark/premade/underdark/start,
/turf/simulated/floor/plating/turfpack/muriki,
/area/mine/explored/muriki/cave/deepdark)
"d" = (
/turf/simulated/mineral/floor/ignore_cavegen/turfpack/muriki,
/area/mine/explored/muriki/cave/deepdark)
"g" = (
/obj/effect/catwalk_plated,
/turf/simulated/floor/maglev{
	icon_state = "maglevside"
	},
/area/mine/explored/muriki/cave/deepdark)
"i" = (
/turf/simulated/floor/plating/turfpack/muriki,
/area/mine/explored/muriki/cave/deepdark)
"j" = (
/turf/simulated/mineral/floor/ignore_cavegen/turfpack/muriki,
/area/mine/unexplored/muriki/cave/deepdark)
"k" = (
/turf/simulated/floor/tiled/turfpack/muriki,
/area/mine/explored/muriki/cave/deepdark)
"p" = (
/turf/simulated/floor/maglev{
	icon_state = "maglevside"
	},
/area/mine/explored/muriki/cave/deepdark)
"r" = (
/obj/machinery/trailblazer/yellow,
/turf/simulated/mineral/floor/ignore_cavegen/turfpack/muriki,
/area/mine/explored/muriki/cave/deepdark)
"s" = (
/turf/template_noop,
/area/mine/explored/muriki/cave/deepdark)
"A" = (
/turf/simulated/wall,
/area/mine/unexplored/muriki/cave/deepdark)
"I" = (
/obj/effect/shuttle_landmark/premade/underdark/end,
/turf/simulated/floor/plating/turfpack/muriki,
/area/mine/explored/muriki/cave/deepdark)
"L" = (
/turf/template_noop,
/area/mine/unexplored/muriki/cave/deepdark)
"U" = (
/turf/simulated/wall,
/area/mine/explored/muriki/cave/deepdark)
"V" = (
/turf/template_noop,
/area/template_noop)

(1,1,1) = {"
V
V
V
V
V
V
V
V
V
V
V
V
V
V
V
V
"}
(2,1,1) = {"
V
L
L
L
L
j
j
A
A
A
A
L
L
L
L
V
"}
(3,1,1) = {"
V
L
L
L
L
d
d
d
p
p
d
d
d
L
L
V
"}
(4,1,1) = {"
V
L
L
L
d
U
i
i
i
i
i
U
k
d
L
V
"}
(5,1,1) = {"
V
L
L
L
d
d
i
i
i
i
i
k
k
d
L
V
"}
(6,1,1) = {"
V
L
L
L
d
d
i
i
i
c
i
k
k
d
L
V
"}
(7,1,1) = {"
V
L
L
j
d
U
i
i
i
i
i
U
k
d
L
V
"}
(8,1,1) = {"
V
L
L
L
d
d
i
i
i
i
i
d
r
j
L
V
"}
(9,1,1) = {"
V
L
L
L
d
d
i
i
i
i
i
d
d
L
L
V
"}
(10,1,1) = {"
V
L
L
L
d
U
i
i
i
i
i
U
d
j
L
V
"}
(11,1,1) = {"
V
L
L
L
d
d
i
i
i
i
i
d
d
d
L
V
"}
(12,1,1) = {"
V
L
L
L
d
d
i
i
i
i
i
d
r
d
L
V
"}
(13,1,1) = {"
V
L
L
L
d
U
i
i
i
i
i
U
k
d
L
V
"}
(14,1,1) = {"
V
L
L
L
d
d
i
i
i
i
i
k
k
d
L
V
"}
(15,1,1) = {"
V
L
L
L
d
d
i
i
i
i
i
k
k
j
L
V
"}
(16,1,1) = {"
V
L
L
L
s
U
i
i
i
i
i
U
k
L
L
V
"}
(17,1,1) = {"
V
L
L
L
L
d
d
d
p
p
d
d
d
L
L
V
"}
(18,1,1) = {"
V
L
L
L
L
L
j
j
a
a
j
j
L
L
L
V
"}
(19,1,1) = {"
V
L
L
L
L
L
j
j
a
a
j
j
L
L
L
V
"}
(20,1,1) = {"
V
L
L
L
L
L
j
j
a
a
j
L
L
L
L
V
"}
(21,1,1) = {"
V
L
L
L
L
L
j
j
a
a
j
L
L
L
L
V
"}
(22,1,1) = {"
V
L
L
L
L
j
j
j
a
a
j
L
L
L
L
V
"}
(23,1,1) = {"
V
L
L
L
L
j
j
j
a
a
j
L
L
L
L
V
"}
(24,1,1) = {"
V
L
L
L
L
j
j
j
a
a
j
L
L
L
L
V
"}
(25,1,1) = {"
V
L
L
L
L
j
j
j
a
a
j
L
L
L
L
V
"}
(26,1,1) = {"
V
L
L
L
L
j
j
j
a
a
j
L
L
L
L
V
"}
(27,1,1) = {"
V
L
L
L
L
j
j
j
a
a
j
j
L
L
L
V
"}
(28,1,1) = {"
V
L
L
L
L
j
j
j
a
a
j
j
L
L
L
V
"}
(29,1,1) = {"
V
L
L
L
L
L
j
j
a
a
j
j
L
L
L
V
"}
(30,1,1) = {"
V
L
L
L
L
L
j
j
a
a
j
j
L
L
L
V
"}
(31,1,1) = {"
V
L
L
L
L
L
j
j
a
a
j
j
L
L
L
V
"}
(32,1,1) = {"
V
L
L
L
L
L
L
j
a
a
j
j
L
L
L
V
"}
(33,1,1) = {"
V
L
L
L
L
L
L
j
a
a
j
L
L
L
L
V
"}
(34,1,1) = {"
V
L
L
L
L
L
L
j
a
a
j
j
L
L
L
V
"}
(35,1,1) = {"
V
L
L
L
L
L
L
j
a
a
j
j
L
L
L
V
"}
(36,1,1) = {"
V
L
L
L
L
L
L
j
a
a
j
j
L
L
L
V
"}
(37,1,1) = {"
V
L
L
L
L
L
L
j
a
a
j
j
L
L
L
V
"}
(38,1,1) = {"
V
L
L
L
L
L
j
j
a
a
j
j
L
L
L
V
"}
(39,1,1) = {"
V
L
L
L
L
L
j
j
a
a
j
j
L
L
L
V
"}
(40,1,1) = {"
V
L
L
L
L
L
j
j
a
a
j
j
L
L
L
V
"}
(41,1,1) = {"
V
L
L
L
L
L
j
j
a
a
j
j
L
L
L
V
"}
(42,1,1) = {"
V
L
L
L
L
j
j
j
a
a
j
L
L
L
L
V
"}
(43,1,1) = {"
V
L
L
L
L
j
j
j
a
a
j
L
L
L
L
V
"}
(44,1,1) = {"
V
L
L
L
L
j
j
j
a
a
j
L
L
L
L
V
"}
(45,1,1) = {"
V
L
L
L
L
j
j
j
a
a
j
L
L
L
L
V
"}
(46,1,1) = {"
V
L
L
L
L
j
j
j
a
a
j
L
L
L
L
V
"}
(47,1,1) = {"
V
L
L
L
L
L
j
j
a
a
j
L
L
L
L
V
"}
(48,1,1) = {"
V
L
L
L
L
L
j
j
a
a
j
j
L
L
L
V
"}
(49,1,1) = {"
V
L
L
L
L
L
j
j
a
a
j
j
L
L
L
V
"}
(50,1,1) = {"
V
L
L
L
L
L
L
j
a
a
j
j
L
L
L
V
"}
(51,1,1) = {"
V
L
L
L
L
L
L
j
a
a
j
j
L
L
L
V
"}
(52,1,1) = {"
V
L
L
L
L
L
L
j
a
a
j
j
L
L
L
V
"}
(53,1,1) = {"
V
L
L
L
L
L
j
j
a
a
j
j
L
L
L
V
"}
(54,1,1) = {"
V
L
L
L
s
s
d
d
p
a
j
j
L
L
L
V
"}
(55,1,1) = {"
V
L
L
L
s
s
d
d
p
p
d
d
s
s
L
V
"}
(56,1,1) = {"
V
L
L
s
s
d
d
d
p
p
d
r
s
s
L
V
"}
(57,1,1) = {"
V
L
L
s
s
d
i
i
g
g
i
i
s
s
L
V
"}
(58,1,1) = {"
V
L
L
s
s
d
i
i
g
g
i
i
s
s
L
V
"}
(59,1,1) = {"
V
L
L
s
s
d
r
d
p
p
d
d
s
s
L
V
"}
(60,1,1) = {"
V
L
L
s
s
s
d
d
p
p
d
s
s
s
L
V
"}
(61,1,1) = {"
V
L
L
L
L
L
j
j
a
a
j
L
L
L
L
V
"}
(62,1,1) = {"
V
L
L
L
L
j
j
j
a
a
j
L
L
L
L
V
"}
(63,1,1) = {"
V
L
L
L
L
j
j
j
a
a
j
L
L
L
L
V
"}
(64,1,1) = {"
V
L
L
L
L
j
j
j
a
a
j
L
L
L
L
V
"}
(65,1,1) = {"
V
L
L
L
L
j
j
j
a
a
j
L
L
L
L
V
"}
(66,1,1) = {"
V
L
L
L
L
j
j
j
a
a
j
L
L
L
L
V
"}
(67,1,1) = {"
V
L
L
L
L
j
j
j
a
a
j
j
L
L
L
V
"}
(68,1,1) = {"
V
L
L
L
L
j
j
j
a
a
j
j
L
L
L
V
"}
(69,1,1) = {"
V
L
L
L
L
L
j
j
a
a
j
j
L
L
L
V
"}
(70,1,1) = {"
V
L
L
L
L
L
j
j
a
a
j
j
L
L
L
V
"}
(71,1,1) = {"
V
L
L
L
L
L
j
j
a
a
j
j
L
L
L
V
"}
(72,1,1) = {"
V
L
L
L
L
L
L
j
a
a
j
j
L
L
L
V
"}
(73,1,1) = {"
V
L
L
L
L
L
L
j
a
a
j
L
L
L
L
V
"}
(74,1,1) = {"
V
L
L
L
L
L
L
j
a
a
j
j
L
L
L
V
"}
(75,1,1) = {"
V
L
L
L
L
L
L
j
a
a
j
j
L
L
L
V
"}
(76,1,1) = {"
V
L
L
L
L
L
L
j
a
a
j
j
L
L
L
V
"}
(77,1,1) = {"
V
L
L
L
L
L
L
j
a
a
j
j
L
L
L
V
"}
(78,1,1) = {"
V
L
L
L
L
L
j
j
a
a
j
j
L
L
L
V
"}
(79,1,1) = {"
V
L
L
L
L
L
j
j
a
a
j
j
L
L
L
V
"}
(80,1,1) = {"
V
L
L
L
L
L
j
j
a
a
j
j
L
L
L
V
"}
(81,1,1) = {"
V
L
L
L
L
L
j
j
a
a
j
j
L
L
L
V
"}
(82,1,1) = {"
V
L
L
L
L
j
j
j
a
a
j
L
L
L
L
V
"}
(83,1,1) = {"
V
L
L
L
L
j
j
j
a
a
j
L
L
L
L
V
"}
(84,1,1) = {"
V
L
L
L
L
j
j
j
a
a
j
L
L
L
L
V
"}
(85,1,1) = {"
V
L
L
L
L
j
j
j
a
a
j
L
L
L
L
V
"}
(86,1,1) = {"
V
L
L
L
L
j
j
j
a
a
j
L
L
L
L
V
"}
(87,1,1) = {"
V
L
L
L
L
L
j
j
a
a
j
L
L
L
L
V
"}
(88,1,1) = {"
V
L
L
L
L
L
j
j
a
a
j
j
L
L
L
V
"}
(89,1,1) = {"
V
L
L
L
L
L
j
j
a
a
j
j
L
L
L
V
"}
(90,1,1) = {"
V
L
L
L
L
L
L
j
a
a
j
j
L
L
L
V
"}
(91,1,1) = {"
V
L
L
L
L
L
L
j
a
a
j
j
L
L
L
V
"}
(92,1,1) = {"
V
L
L
L
L
L
L
j
a
a
j
j
L
L
L
V
"}
(93,1,1) = {"
V
L
L
L
L
L
j
j
a
a
j
j
L
L
L
V
"}
(94,1,1) = {"
V
L
L
L
L
L
j
j
a
a
j
j
L
L
L
V
"}
(95,1,1) = {"
V
L
L
L
L
L
j
j
a
a
j
j
L
L
L
V
"}
(96,1,1) = {"
V
L
L
L
L
j
j
j
a
a
j
j
L
L
L
V
"}
(97,1,1) = {"
V
L
L
L
L
j
j
j
a
a
j
j
L
L
L
V
"}
(98,1,1) = {"
V
L
L
L
L
j
j
j
a
a
j
j
L
L
L
V
"}
(99,1,1) = {"
V
L
L
L
L
j
j
j
a
a
j
j
L
L
L
V
"}
(100,1,1) = {"
V
L
L
L
L
j
j
j
a
a
j
j
L
L
L
V
"}
(101,1,1) = {"
V
L
L
L
L
j
j
j
a
a
j
j
L
L
L
V
"}
(102,1,1) = {"
V
L
L
L
L
d
d
d
p
p
d
L
L
L
L
V
"}
(103,1,1) = {"
V
L
L
L
s
s
d
d
p
p
d
s
L
L
L
V
"}
(104,1,1) = {"
V
L
L
s
s
U
i
i
i
i
i
U
k
s
L
V
"}
(105,1,1) = {"
V
L
L
s
s
d
i
i
i
i
i
k
k
s
L
V
"}
(106,1,1) = {"
V
L
L
s
s
d
i
i
i
I
i
k
k
s
L
V
"}
(107,1,1) = {"
V
L
L
s
s
U
i
i
i
i
i
U
k
s
L
V
"}
(108,1,1) = {"
V
L
L
s
s
d
i
i
i
i
i
d
r
s
L
V
"}
(109,1,1) = {"
V
L
L
s
d
d
i
i
i
i
i
d
d
s
L
V
"}
(110,1,1) = {"
V
L
L
s
d
U
i
i
i
i
i
U
d
s
L
V
"}
(111,1,1) = {"
V
L
L
d
d
d
i
i
i
i
i
d
d
s
L
V
"}
(112,1,1) = {"
V
L
L
d
d
d
i
i
i
i
i
d
r
s
L
V
"}
(113,1,1) = {"
V
L
L
d
d
U
i
i
i
i
i
U
k
s
L
V
"}
(114,1,1) = {"
V
L
L
d
d
d
i
i
i
i
i
k
k
s
L
V
"}
(115,1,1) = {"
V
L
L
d
d
d
i
i
i
i
i
k
k
s
L
V
"}
(116,1,1) = {"
V
L
L
d
d
U
i
i
i
i
i
U
k
s
L
V
"}
(117,1,1) = {"
V
L
L
j
d
d
d
d
p
p
d
s
s
L
L
V
"}
(118,1,1) = {"
V
L
L
j
j
d
d
U
U
U
U
s
L
L
L
V
"}
(119,1,1) = {"
V
L
L
L
j
j
j
j
j
j
L
L
L
L
L
V
"}
(120,1,1) = {"
V
V
V
V
V
V
V
V
V
V
V
V
V
V
V
V
"}
