//MAP CONVERTED BY dmm2tgm.py THIS HEADER COMMENT PREVENTS RECONVERSION, DO NOT REMOVE
"a" = (
/turf/template_noop,
/area/template_noop)
"U" = (
/obj/effect/landmark/step_trap,
/turf/simulated/mineral/floor/ignore_cavegen/turfpack/muriki,
/area/mine/explored/muriki/cave/deepdark)

(1,1,1) = {"
a
a
a
"}
(2,1,1) = {"
a
U
a
"}
(3,1,1) = {"
a
a
a
"}
