//MAP CONVERTED BY dmm2tgm.py THIS HEADER COMMENT PREVENTS RECONVERSION, DO NOT REMOVE
"a" = (
/turf/simulated/mineral/floor/ignore_cavegen/turfpack/muriki,
/area/mine/unexplored/muriki/cave/deepdark)
"f" = (
/turf/template_noop,
/area/template_noop)
"k" = (
/turf/simulated/mineral/floor/ignore_cavegen/turfpack/muriki,
/area/mine/explored/muriki/cave/deepdark)
"l" = (
/turf/simulated/floor/plating/turfpack/muriki,
/area/mine/explored/muriki/cave/deepdark)
"o" = (
/turf/simulated/mineral/alt/ignore_mapgen/turfpack/muriki,
/area/mine/explored/muriki/cave/deepdark)
"r" = (
/turf/template_noop,
/area/mine/unexplored/muriki/cave/deepdark)
"x" = (
/obj/machinery/trailblazer/yellow,
/turf/simulated/mineral/floor/ignore_cavegen/turfpack/muriki,
/area/mine/explored/muriki/cave/deepdark)
"y" = (
/turf/simulated/wall,
/area/mine/explored/muriki/cave/deepdark)
"J" = (
/obj/machinery/door/airlock/maintenance/common,
/turf/simulated/floor/plating/turfpack/muriki,
/area/mine/explored/muriki/cave/deepdark)
"X" = (
/turf/simulated/mineral/alt/ignore_mapgen/turfpack/muriki,
/area/mine/unexplored/muriki/cave/deepdark)

(1,1,1) = {"
f
f
f
f
f
f
f
f
f
f
f
f
f
f
f
f
f
f
f
f
f
f
f
f
f
f
f
f
f
f
"}
(2,1,1) = {"
f
X
X
r
r
r
r
r
r
r
r
r
r
r
r
r
r
r
r
r
r
r
r
r
r
r
r
r
X
f
"}
(3,1,1) = {"
f
X
X
X
X
X
a
r
r
r
r
r
r
r
a
a
a
r
r
r
r
r
r
r
r
r
X
X
X
f
"}
(4,1,1) = {"
f
X
X
X
X
X
X
a
a
r
r
a
a
a
a
a
a
a
r
r
r
a
a
a
X
X
X
X
X
f
"}
(5,1,1) = {"
f
X
X
X
X
X
X
o
k
k
k
k
k
k
k
x
k
k
k
k
k
k
k
k
o
o
o
X
X
f
"}
(6,1,1) = {"
f
o
o
o
o
o
o
o
k
x
k
k
k
k
k
k
k
k
k
k
k
x
k
o
o
o
o
o
o
f
"}
(7,1,1) = {"
f
o
y
o
o
o
y
k
k
k
k
y
l
l
y
k
y
l
l
y
k
k
k
o
y
o
o
o
y
f
"}
(8,1,1) = {"
f
o
o
o
y
y
y
y
y
y
y
y
J
J
y
y
y
J
J
y
y
y
y
y
y
y
y
o
o
f
"}
(9,1,1) = {"
f
o
y
o
o
o
y
o
k
k
k
y
l
l
y
k
y
l
l
y
k
k
k
k
y
o
o
o
y
f
"}
(10,1,1) = {"
f
o
o
o
o
o
o
o
k
x
k
k
k
k
k
k
k
k
k
k
k
x
k
k
o
o
o
o
o
f
"}
(11,1,1) = {"
f
o
o
o
o
o
o
o
k
k
k
k
k
k
k
k
x
k
k
k
k
k
k
k
o
o
o
o
o
f
"}
(12,1,1) = {"
f
X
X
X
X
X
k
k
k
k
k
r
r
r
a
k
k
k
k
a
r
r
a
a
r
X
X
X
X
f
"}
(13,1,1) = {"
f
X
X
X
r
a
a
a
r
r
r
r
r
r
r
r
r
r
r
r
r
r
r
r
r
r
X
X
X
f
"}
(14,1,1) = {"
f
X
X
r
r
r
r
r
r
r
r
r
r
r
r
r
r
r
r
r
r
r
r
r
r
r
r
r
X
f
"}
(15,1,1) = {"
f
f
f
f
f
f
f
f
f
f
f
f
f
f
f
f
f
f
f
f
f
f
f
f
f
f
f
f
f
f
"}
