//MAP CONVERTED BY dmm2tgm.py THIS HEADER COMMENT PREVENTS RECONVERSION, DO NOT REMOVE
"a" = (
/turf/template_noop,
/area/mine/unexplored/muriki/cave/deepdark)
"m" = (
/obj/machinery/door/airlock/maintenance/common,
/turf/simulated/floor/plating/turfpack/muriki,
/area/mine/explored/muriki/cave/deepdark)
"s" = (
/obj/machinery/trailblazer/yellow,
/turf/simulated/mineral/floor/ignore_cavegen/turfpack/muriki,
/area/mine/explored/muriki/cave/deepdark)
"t" = (
/turf/template_noop,
/area/template_noop)
"B" = (
/turf/simulated/mineral/floor/ignore_cavegen/turfpack/muriki,
/area/mine/unexplored/muriki/cave/deepdark)
"H" = (
/turf/simulated/floor/plating/turfpack/muriki,
/area/mine/explored/muriki/cave/deepdark)
"Q" = (
/turf/simulated/mineral/alt/ignore_mapgen/turfpack/muriki,
/area/mine/explored/muriki/cave/deepdark)
"S" = (
/turf/simulated/mineral/alt/ignore_mapgen/turfpack/muriki,
/area/mine/unexplored/muriki/cave/deepdark)
"V" = (
/turf/simulated/mineral/floor/ignore_cavegen/turfpack/muriki,
/area/mine/explored/muriki/cave/deepdark)
"X" = (
/turf/simulated/wall,
/area/mine/explored/muriki/cave/deepdark)

(1,1,1) = {"
t
t
t
t
t
t
t
t
t
t
t
t
t
t
t
"}
(2,1,1) = {"
t
a
S
S
S
S
X
Q
X
S
S
S
S
S
t
"}
(3,1,1) = {"
t
a
a
S
S
Q
Q
Q
Q
Q
S
S
S
a
t
"}
(4,1,1) = {"
t
a
a
S
S
Q
Q
Q
Q
Q
S
S
S
a
t
"}
(5,1,1) = {"
t
a
a
B
S
Q
Q
X
V
V
Q
S
a
a
t
"}
(6,1,1) = {"
t
a
a
B
V
V
X
X
X
V
Q
S
a
a
t
"}
(7,1,1) = {"
t
a
a
B
V
V
V
X
V
V
V
B
a
a
t
"}
(8,1,1) = {"
t
a
a
B
V
s
V
X
V
V
V
B
a
a
t
"}
(9,1,1) = {"
t
a
a
a
V
V
V
X
V
s
V
a
a
a
t
"}
(10,1,1) = {"
t
a
a
a
V
V
V
X
V
V
V
a
a
a
t
"}
(11,1,1) = {"
t
a
a
a
V
V
X
X
X
V
V
a
a
a
t
"}
(12,1,1) = {"
t
a
a
B
V
V
H
m
H
V
V
B
a
a
t
"}
(13,1,1) = {"
t
a
a
B
V
V
H
m
H
V
V
B
a
a
t
"}
(14,1,1) = {"
t
a
a
B
V
V
X
X
X
V
V
B
a
a
t
"}
(15,1,1) = {"
t
a
a
B
s
V
V
X
V
V
s
B
a
a
t
"}
(16,1,1) = {"
t
a
a
B
V
V
X
X
X
V
V
B
a
a
t
"}
(17,1,1) = {"
t
a
a
B
V
V
H
m
H
V
V
B
a
a
t
"}
(18,1,1) = {"
t
a
a
B
V
V
H
m
H
V
V
B
a
a
t
"}
(19,1,1) = {"
t
a
a
a
V
V
X
X
X
V
V
B
a
a
t
"}
(20,1,1) = {"
t
a
a
a
V
V
V
X
V
V
V
a
a
a
t
"}
(21,1,1) = {"
t
a
a
a
V
V
V
X
V
V
V
a
a
a
t
"}
(22,1,1) = {"
t
a
a
B
V
s
V
X
V
s
V
a
a
a
t
"}
(23,1,1) = {"
t
a
a
B
V
V
V
X
V
V
V
B
a
a
t
"}
(24,1,1) = {"
t
a
a
a
V
V
X
X
X
V
V
B
a
a
t
"}
(25,1,1) = {"
t
a
a
a
B
Q
V
X
V
Q
B
B
a
a
t
"}
(26,1,1) = {"
t
a
a
a
S
Q
Q
X
Q
Q
B
B
a
a
t
"}
(27,1,1) = {"
t
a
a
S
S
Q
Q
Q
Q
S
S
a
a
a
t
"}
(28,1,1) = {"
t
a
a
S
S
S
X
Q
X
S
S
S
a
a
t
"}
(29,1,1) = {"
t
a
S
S
S
S
S
S
S
S
S
S
S
a
t
"}
(30,1,1) = {"
t
t
t
t
t
t
t
t
t
t
t
t
t
t
t
"}
