//MAP CONVERTED BY dmm2tgm.py THIS HEADER COMMENT PREVENTS RECONVERSION, DO NOT REMOVE
"a" = (
/turf/simulated/wall/titanium,
/area/template_noop)
"n" = (
/turf/template_noop,
/area/template_noop)
"o" = (
/mob/living/simple_mob/vore/wolftaur/syndicate/alt2,
/turf/simulated/floor/reinforced,
/area/template_noop)
"q" = (
/obj/structure/droppod_door,
/mob/living/simple_mob/vore/wolf/direwolf/syndicate/black,
/mob/living/simple_mob/vore/wolf/direwolf/syndicate/black,
/turf/simulated/floor/reinforced,
/area/template_noop)
"r" = (
/obj/structure/droppod_door{
	dir = 1
	},
/mob/living/simple_mob/vore/wolf/direwolf/syndicate/black,
/mob/living/simple_mob/vore/wolf/direwolf/syndicate/black,
/turf/simulated/floor/reinforced,
/area/template_noop)
"D" = (
/mob/living/simple_mob/vore/wolftaur/syndicate/alt3,
/turf/simulated/floor/reinforced,
/area/template_noop)
"I" = (
/mob/living/simple_mob/vore/wolftaur/syndicate/smg,
/turf/simulated/floor/reinforced,
/area/template_noop)
"P" = (
/obj/structure/droppod_door{
	dir = 8
	},
/mob/living/simple_mob/vore/wolftaur/syndicate/lmg,
/turf/simulated/floor/reinforced,
/area/template_noop)
"T" = (
/mob/living/simple_mob/vore/wolftaur/syndicate/alt1,
/turf/simulated/floor/reinforced,
/area/template_noop)
"Z" = (
/obj/structure/droppod_door{
	dir = 4
	},
/mob/living/simple_mob/vore/wolftaur/syndicate/lmg,
/turf/simulated/floor/reinforced,
/area/template_noop)

(1,1,1) = {"
n
a
Z
a
n
"}
(2,1,1) = {"
a
a
T
a
a
"}
(3,1,1) = {"
q
I
D
I
r
"}
(4,1,1) = {"
a
a
o
a
a
"}
(5,1,1) = {"
n
a
P
a
n
"}
